keyword	user_intent
chiropractic courses	INFO
what is this coin worth	DA
what color is sable brown	DA
special needs activities	INFO
what is carcinoma	DA
coconut oil cream for skin	BUY
free online canasta	NAV
remove dark spots on skin	DA
how do you get spider mites	DA
air climate control	GEN
causes for receding gums	INFO
havanese dogs	GEN
mini goldendoodles rescue	GEN
what causes hair to turn gray	DA
poplar trees	GEN
baptism cake ideas	INFO
pay mortgage off early	INFO
which stores accept wic	DA
delete all websites visited	DA
bank by sort code	INFO
broken humerus treatment	INFO
where to find almond oil	BUY
felony record expunged	GEN
owl sounds hoot	INFO
chiggers pictures of bites	RES
snake cake pan	BUY
what do doves like to eat	DA
diagnostic auto scanner	BUY
who makes nexen tires	DA
pin oak tree pictures	RES
learn algebra	GEN
florida renewal	NAV
bones of the spinal column	GEN
correction astigmatism	INFO
pictures of bowel obstruction	RES
prognosis of throat cancer	GEN
candy names list a to z	INFO
smallpox disease	GEN
template pay stub	RES
value old postcards	BUY
what is a salt lamp benefits	DA
natural hair relaxers	BUY
electrician certification test	INFO
moen faucet instructions	RES
snake repellent lowes	NAV
what is usda loan	DA
how do i send a telegram	DA
getting body odor out of clothes	DA
registered us mail tracking	NAV
zonolite attic insulation	BUY
normal heart beats per minute	DA
get rid of garden snakes	DA
the mensa iq test	GEN
white spots on toenails	GEN
can am rt	BUY
treasury unclaimed money	GEN
oil of primrose side effects	INFO
grams to carbs calculator	RES
what is a legal entity	DA
lowes garage opener	BUY
biotin deficiency symptoms	INFO
odometer parts	BUY
how to eliminate sugar ants	DA
symptoms parvo dogs	DA
fertilizer bermuda grass	INFO
side effects resveratrol	INFO
best chipmunk trap	DA
how to grow artichoke plants	DA
my vin number	GEN
turning 60 saying	INFO
gold bars worth	DA
list of good carbs	DA
best multivitamins brands	INFO
writing a invoice	DA
truck body mounts	BUY
loss 30 pounds in 30 days	GEN
multiple listings service	GEN
do i pay tax on my pension	DA
are teeth bones	DA
how to catch shad	DA
diet for hashimotos disease	GEN
centrifugal spin dryer	BUY
big snakes in the world	INFO
onset of food poisoning	GEN
lawn devil mower	BUY
performance comments	GEN
brick prices per square foot	INFO
silverado towing capacity	DA
how to refinish oak cabinets	DA
blood sugar level high	INFO
how to paint wood cabinets	DA
how to calculate drywall cost	DA
little black flying bugs	GEN
signs of approaching death	INFO
how to put music on mp3	DA
algebra pizzazz answers	RES
about the pituitary gland	GEN
sea turtles eggs facts	GEN
fmla forms	RES
looking for a grave	GEN
what can cause sepsis	DA
pure moringa benefits	DA
irrigation pump parts	BUY
a picture of mona lisa	RES
peter please answer website	NAV
ways to go sleep	INFO
best time to plant tulip bulbs	DA
how to wrap a broken toe	DA
is wheat germ good for you	DA
ca real estate license online	NAV
exercises for a pulled groin	INFO
value of 1940 nickel	DA
best ant killer	DA
pistachio pound cake	DA
best pocket knife	DA
pictures of lumps in the neck	RES
pigeon racing loft	BUY
glomerular filtration rate	GEN
current hog prices	DA
what is a glycolic peel	DA
imei number	GEN
chronic asthma	GEN
michelob ultra coupons	RES
gym contract example	RES
what do baby pigeons eat	DA
how long do bruises last	DA
prices of lamborghini cars	BUY
how to clear all history	DA
compression of the spine	GEN
where is the thyroid located	DA
how to do decimal division	DA
how many syllables in a word	DA
iris quilt pattern	RES
cure for prostate cancer	GEN
where to get soursop juice	DA
download pa state tax form	RES
how to replace wiper blades	DA
diabetes how to control	DA
amazon phone number call	DA
bull mastiffs for sale	BUY
red eye flights	BUY
huntington korea disease	GEN
how can you find people	DA
meatballs in slow cooker	DA
how to kill mites on plants	DA
how to enable flash player	DA
how big is lebron james	DA
cpi certification online	NAV
renewal letter sample	RES
air control valve	GEN
what is thoracic surgery	DA
phone voip	GEN
king size beds for cheap	BUY
aquarius male personality	GEN
what causes retinal tears	DA
symptoms of hip osteoarthritis	INFO
home remedy ant killer	INFO
exterior windows	BUY
pressure tank for water well	BUY
printable pictures of penguins	RES
when to plant corn	DA
carbohydrates in rice	GEN
cribbage board template	RES
zip code map az	RES
face fat removal	GEN
what causes all over itching	DA
glass bottle worth	BUY
egg science projects	INFO
pure olive oil for skin	BUY
horoscope december	GEN
how do i calculate my apr	DA
epiphone guitar serial numbers	GEN
duties of church ushers	INFO
valuable coins	GEN
party cheese platter	BUY
broken nose symptoms	INFO
can diabetics eat watermelon	DA
have i been caught speeding	DA
white glitter paint	BUY
dog worm symptoms	INFO
dog shampoo malaseb	BUY
ficus trees care	GEN
what is blood poisoning	DA
blood and glucose in urine	GEN
indoor succulent plants	GEN
causes of computer virus	INFO
cheap furniture sets bedroom	BUY
what does australia export	DA
convert centimeter to inches	DA
whitening glutathione	GEN
general tire dealer	BUY
collection of judgments	GEN
holistic eye doctors	GEN
hydroxycitric acid foods	GEN
civil lawsuits cases	GEN
what removes dark spots	DA
how to cook a whole salmon	DA
rare wheat pennies 1943	GEN
six steps of problem solving	DA
play zuma games online	NAV
catalog of coins	RES
polar bear in antarctica	GEN
what is a mitral valve prolapse	DA
bleeding ulcer symptoms	INFO
cholesterol ratio ideal	DA
what to do for calf cramps	DA
hip arthritis treatments	INFO
free rss news feeds	INFO
back pain sacroiliac joint	GEN
what do trout eat	DA
divorce decree copy	RES
is there gluten in wheat bran	DA
fleet manager responsibilities	INFO
how to freeze butternut squash	DA
how long shingles pain last	DA
barn door accessories	BUY
how to rid of kidney stones	DA
price to renew green card	DA
what do pet salamanders eat	DA
convert ml to mg ml	DA
perennial plants for borders	INFO
what is gel for nails	DA
how to dehydrate beef jerky	DA
how to calculate my apr	DA
undetectable viral load	GEN
60th birthday ideas for her	INFO
what is resveratrol good for	DA
stunted growth in children	GEN
twic status	NAV
magnetic water softener	BUY
average welfare payment	DA
why do my brakes squeak	DA
exterior prehung door	BUY
toy worth	GEN
dangers of gmo food	GEN
40th birthday ideas for men	INFO
wells credit cards	GEN
what cause swollen legs	DA
bacterial infection in throat	GEN
the name of all the shapes	DA
make hummingbird feeder	DA
teflon broiler pan	BUY
tracfone plans unlimited	BUY
weight loss protein diet	GEN
government grants for men	GEN
under skin itching	GEN
sycamore tree diseases	INFO
compound	GEN
how to color your hair ombre	DA
how to poison voles	DA
garlic for toenail fungus	GEN
usa pledge of allegiance	DA
how to build a motorcycle	DA
vinegars	GEN
what to do for ringworm	DA
calf pain treatment	INFO
flushed cheeks causes	INFO
repellent for dogs	BUY
causes of skin peeling on hands	DA
grindley pottery marks	GEN
pictures of red spiders	RES
remove ingrown hair face	DA
where to buy sea moss	BUY
unscramble a word	DA
best rated multivitamins	DA
blood clot in calf	GEN
bed headboard brackets	BUY
pancreas diet plan	DA
south african mastiff	GEN
foods that increase serotonin	DA
rash with lower back pain	GEN
what are good study skills	DA
prognosis esophageal cancer	DA
vitamin b12 gel	GEN
online quickbooks	RES
a list of country codes	DA
gsm prepaid phones	BUY
how to amortization schedule	DA
nursing research topics	INFO
distressed finish furniture	BUY
cost of living increase	GEN
residential window sizes	INFO
job transfer letter sample	RES
positive ana test	GEN
sell photos	GEN
what do deers eat for food	DA
supraspinatus tendon surgery	GEN
mobile phone sim cards	BUY
personal care	GEN
ants in home	GEN
how do you spread shingles	DA
color schemes wheel	RES
side effects of a colonoscopy	DA
size of normal aorta	DA
natural laxative	GEN
low red blood cell count means	DA
lactose intolerance remedies	INFO
raccoon repellent sound	BUY
how to lower hemoglobin	DA
free cell phone ringbacks	RES
how to kill bees nest	DA
calculate alimony	DA
bursitis in hip treatment	INFO
in line circuit breaker	GEN
where hawaii is located	DA
lung transplant list	RES
middle upper back pain	GEN
diseases of birch trees	GEN
lathe machine parts	BUY
sugar count for diabetics	GEN
ubiquinol form of coq10	GEN
what is protein c	DA
write an obituary template	RES
what cures sleep apnea	DA
birthday ideas for guys	INFO
aftershock	GEN
wood floor sander	BUY
ford mustang fuse box	GEN
vygotsky theory	GEN
what to do for snake bite	DA
subnet mask gateway	GEN
old plumb bob	BUY
private home care	GEN
crepe myrtle fertilizer	INFO
free depression test online	RES
antique glass paperweights	BUY
home flour mills	BUY
how to convert to linear feet	DA
eye color charts	RES
make myself go into labor	DA
class a drivers license	GEN
message of sympathy	INFO
menstrual cramp remedies	INFO
what is ginkgo biloba used for	DA
painful lump on spine	GEN
uric acid levels for gout	DA
pictures of recluse spider	RES
meats low in potassium list	DA
dreams come true	GEN
birdie golf	GEN
number 10 envelope size	BUY
bayer grub control	BUY
diet for menieres disease	DA
side effect of flaxseed oil	DA
sand filter for well water	BUY
stage 2 cancer	GEN
the life of mother teresa	GEN
what are the rules of uno	DA
different types of advertising	GEN
post gallbladder surgery diet	DA
who is charles darwin	DA
plumbago plant care	GEN
dc power supply	GEN
my reading log	NAV
hotmail new account sign up	NAV
shoes for flat feet	BUY
is multiple myeloma cancer	DA
best ingrown hair treatment	DA
swimming pool algaecide	BUY
front disc brakes	GEN
shih tzu puppies in texas	BUY
octagon soap bar	BUY
capital city of africa	DA
the best apples for pie	DA
flax seed oil health benefits	INFO
is olive oil good for the hair	DA
afni collection agency	NAV
email scams	GEN
where to buy rue herb	DA
bleeding on brain	GEN
how to lower leaf springs	DA
poems about nieces	INFO
price of 14 karat gold	BUY
best way to kill grubs in lawn	DA
cure for tickle in throat	DA
sea turtle facts for kids	GEN
natural cure for hiv	GEN
cute grey kitten names	INFO
how to get mildew smell out	DA
right shoulder pain down arm	GEN
most popular tattoos designs	RES
what is slurred speech	DA
ink for temporary tattoos	BUY
how do i get a money order	DA
how to flush your kidneys	DA
reiki and healing	GEN
best time to aerate a lawn	DA
bank beneficiary	GEN
serger machines	BUY
what is a saffron	DA
laundry sinks with cabinets	BUY
new product pricing strategy	GEN
short rhyming love poems	INFO
social security earnings limits	GEN
low glycemic flour	BUY
folk nation gangster disciples	GEN
curtain and rods	BUY
swift codes for us banks	GEN
question day kids	GEN
full size daybeds	BUY
pg&e website	NAV
what is the cause of dry lips	DA
play hearts card game online	NAV
ticks lay eggs in humans	GEN
usps media mail tracking	NAV
matric exams results	NAV
chemical peel glycolic acid	GEN
badlands national park map	RES
how to create my apple id	DA
sewing machine decals	BUY
minecraft texture pack list	RES
cholesterol in eyes pictures	RES
rit dye for polyester	BUY
sandwich shops for sale	INFO
shabby chic catalogs	RES
pomeranian names female	INFO
cold ice packs	GEN
california king bed frame	BUY
original edison light bulb	GEN
free algebra calculator online	NAV
common house spider	GEN
antique marbles for sale	BUY
types pollution	GEN
aquasource faucet reviews	BUY
photo caption	GEN
what is modified food starch	DA
pictures of femoral hernias	NAV
monocytes absolute count	GEN
how to do a quick messy bun	DA
queen elizabeth 1 history	GEN
apply for college	GEN
facts planet uranus	GEN
office 365 for individuals	BUY
causes for slurred speech	DA
aftermarket cold air intake	BUY
half dollar	GEN
top s&p 500 index funds	GEN
cures for positional vertigo	INFO
miracles st anthony	GEN
kohler parts lookup	NAV
cats drink milk	DA
colorado united states map	RES
lily bulbs care	GEN
bladeless ceiling fan	BUY
what is bursitis elbow	DA
what is an ileus symptoms	DA
when is retirement age	DA
what is the normal iron level	DA
example of quit claim deed	RES
flush car radiator	DA
what is blossom end rot	DA
can you freeze lobster	DA
centipede bite treatment	INFO
manufacturing companies	INFO
river otters facts	GEN
rules for rummy 500	DA
short poems for mothers	INFO
how do people get autism	DA
ingrown hair prevention	GEN
signs low estrogen	INFO
code of conduct and ethics	GEN
potassium free foods	DA
type a positive blood diet	DA
how to make a bumble bee	DA
how calculate cubic yards	DA
fruits high in fiber	INFO
causes of spots on the liver	DA
custody laws in virginia	GEN
flaxseed and diabetes	GEN
caffeine free sodas	INFO
nutritional value of cherries	DA
5 month old baby food	INFO
teeth falling out	GEN
four stroke engine	GEN
how do i delete my account	DA
good science projects	INFO
how much is a parachute	DA
see yourself with braces	RES
picture of rat snake	RES
view private twitter	DA
list of foods low in sodium	INFO
joel osteen on tv	GEN
stent procedure recovery	GEN
pool tables dimensions	DA
new carpal tunnel surgery	GEN
shower curtains yellow	BUY
can a torn meniscus heal	DA
real time tracker	BUY
motion for judgement	GEN
meaning of irony	DA
flood certification fema	NAV
names of irish immigrants	INFO
how to remove milk stains	DA
what is thyroid gland disease	DA
best way to cure bad breath	DA
how to clean your humidifier	DA
lymph node cancer	GEN
basic presbyterian beliefs	GEN
what kills crickets	DA
price guide for old records	RES
datura angel trumpet	GEN
bank deposit slip form	RES
rates of interest	GEN
remedies for dry flaky scalp	INFO
how to boil raw shrimp	DA
pregnancy baby gender	GEN
does kiwi freeze well	DA
what do chiggers look like	DA
what are signs of period	DA
tribal symbols meanings	INFO
sweet 16 party themes girls	INFO
spousal support calculator	RES
nodular melanoma	GEN
used suzuki intruder	BUY
shrimp baked in the oven	DA
continental tires online	NAV
in ground junction box	GEN
used boat docks	BUY
yellow spider identification	INFO
st lucia things to do	INFO
sudden swelling of hands	GEN
acai berry weight loss	GEN
how to ferment cabbage	DA
recover deleted history	DA
duracell battery types	DA
the bible meaning of names	GEN
collector stamps values	BUY
oxtail soup crock pot	DA
battery for dodge stratus	BUY
disney collectible dolls	BUY
peer to peer file sharing	GEN
tightness and pain in chest	GEN
nioxin vitamins ingredients	DA
menopause heavy bleeding	GEN
anesthesia side effects	INFO
what causes a brown tongue	DA
brown recluse pictures spider	RES
what to spray on apple trees	DA
chai latte ingredients	DA
amount of sodium in foods	INFO
health benefits ashwagandha	INFO
where are stem cells found	DA
liters to grams	DA
nutritional value of oatmeal	DA
normal inr lab value	DA
trading card prices	BUY
instructions for colonoscopy	INFO
unleaded gas	GEN
symbols for names	RES
where to get a massage	INFO
moen kitchen faucet repair	INFO
what is metabolic syndrome	DA
free asvab book	RES
markers for glass	BUY
convert ratio to fraction	DA
shih tzu skin problems	INFO
hereditary eye diseases	GEN
how to cook purple potatoes	DA
lice on cats	GEN
make your own diet plan free	RES
side effects for folic acid	INFO
civil war veterans	GEN
majesty palm tree	GEN
capital expenditure examples	INFO
government harp program	GEN
project igi 2	BUY
usps money order online	NAV
healthy body fat percentage	GEN
when to prune fig trees	DA
cutting razor blades	GEN
normal thyroid tsh level	DA
pain on left side lower back	GEN
niagara falls pictures	RES
order girl scout cookies online	NAV
shark attacks this year	INFO
signs of appendicitis	INFO
what is cfc certification	DA
in shell walnuts	GEN
install exterior door frame	DA
wifi network setup	DA
how much is a baby pug	DA
play peter answers	NAV
templates for business plans	RES
does baking soda go bad	DA
pictures of chickens hens	RES
causes for excessive burping	INFO
how to find property owners	DA
list of deadly snakes	INFO
naples italy map	RES
what does spleen do in body	DA
silver morgan dollar	GEN
cna practice exam	RES
bloodroot plant	GEN
how big is a horseshoe pit	DA
installing basement window	DA
business plan templates	RES
the stages of dying	GEN
signs of contact dermatitis	INFO
who sells flaxseed oil	DA
hydrogen oxygen separator	GEN
how to find my coat of arms	DA
mass air flow sensor location	DA
top 10 worlds tallest building	DA
saturday open dmv	DA
how to write meeting minute	DA
what is a pet scan for cancer	DA
king david in the bible	GEN
doppler test	GEN
what is a pap smear	DA
indoor fig trees	GEN
nose ear throat specialist	GEN
free anywho com	NAV
stainless steel baking pans	BUY
normal level hemoglobin	DA
neurologist	GEN
fruit and yogurt recipes	INFO
kidney infection in dogs	GEN
arsenal football club	GEN
how to install a shower pan	DA
celtic designs and meanings	INFO
what is elmers glue made of	DA
barclays bank bank	NAV
breeding african cichlids	GEN
signs your having a boy	INFO
droopy eyelids	GEN
chronic ischemic change	GEN
how to update a garmin	DA
htc phones	BUY
french drain installers	INFO
computer wireless	GEN
vinegar mixture to kill weeds	DA
kitchen cupboards for sale	BUY
symptoms of a hemorrhoid	INFO
formula ohm's law	DA
how to freeze cucumbers	DA
what is toxic mold	DA
fax from your computer	DA
job corps information	GEN
causes of milia	INFO
price of rocking chair	DA
how to build window seats	DA
computer input output device	BUY
allergy to eggs symptoms	INFO
corian countertop refinishing	DA
numbness in left thumb	GEN
lhasa apso shih tzu	GEN
potatoes on the grill	GEN
free cpe credits	NAV
xbox 360 game spore	BUY
thalamic stroke	GEN
us banks in the philippines	INFO
baby penguins for sale	BUY
free screensaver pictures	RES
junk yards for auto parts	INFO
tia stroke symptoms	INFO
cost of zerona treatment	DA
strokes in dogs	GEN
private investigator classes	INFO
kitchen banquette ideas	INFO
when to plant vegetables	DA
how to find my time of birth	DA
white bumps on the face	GEN
free vehicle history report	RES
i need a massage therapist	INFO
free basset hound	BUY
hotspot unlimited	GEN
turn on pop up blocker	DA
can alcohol kill bed bugs	DA
uses of bitter leaf	INFO
what is magistrate	DA
canada marriage license	GEN
biopsy of the liver procedure	GEN
lesson plans for toddlers	RES
what is a fha mortgage loan	DA
plantar fasciitis massage	GEN
yellow leaves on squash	GEN
rd loan requirements	DA
how to read decimals	DA
size of badminton court	DA
black cherry juice for gout	GEN
how to grow strawberries	DA
alzheimers life expectancy	GEN
social welfare services	GEN
shop marshalls	NAV
14 karat gold price	DA
iron wall decor	BUY
international operator number	DA
baby shower menus	INFO
normal homocysteine levels	DA
351 windsor horsepower	GEN
krill oil versus fish oil	GEN
what is a stomach aneurysm	DA
gross weight of trucks	GEN
what are dream catchers	DA
bad gas mileage causes	INFO
dollars to yen exchange rate	DA
loan amortization schedule	RES
symptoms of afib	INFO
weed killer reviews	BUY
iodized salt and thyroid	GEN
what is turmeric curcumin	DA
stop dog shedding	DA
anatomy of the knee	GEN
pin up hairstyles	RES
dragonfly larvae	GEN
free quilting patterns	RES
noise cancelling machines	BUY
atv plastic paint	BUY
bath tub remodeling	GEN
where was billy graham born	DA
foods that have potassium	INFO
vintage truck parts	BUY
dark spots on lips	GEN
glass pitcher	BUY
baby mice for sale	BUY
puerto rican furniture	BUY
painful big toe	GEN
about the great lakes	GEN
pain on left side and back	GEN
exotic angel plants	GEN
types of fabrics	INFO
roofing insurance claims	GEN
potassium gluconate dosage	DA
how many amps is 500 watts	DA
cure for nail fungus fast	DA
remodeling a bathroom	DA
water flow switch	GEN
substitute for fresh ginger	DA
bodybuilders	GEN
czechoslovakia china	GEN
shoes for hallux rigidus	BUY
i need a seamstress	INFO
mayonnaise miracle whip	GEN
psyllium fiber	GEN
trust deed	GEN
small species of shark	INFO
types of frogs	INFO
first signs of pregnancy quiz	RES
what is mifi	DA
lowes charcoal grill	BUY
how to remove e6000 glue	DA
hydrochloric acid cleaning	GEN
lamborghini cars prices	DA
diseases of squash plants	GEN
what is the best mole trap	DA
lung cancer in dogs	GEN
how to update garmin	DA
paintless dent repair	GEN
the cause of autism	DA
cost of septic systems	BUY
home remedies tonsillitis	INFO
stage 4 cancer treatment	GEN
treatment for ice pack burn	DA
value of acrosonic piano	BUY
blackwater job openings	NAV
magnifying glass	BUY
diet for high potassium	GEN
what is cancer in the blood	DA
30 notice to vacate letter	RES
fertilizer for raspberry plants	INFO
problems of alcoholism	INFO
potassium alum powder	GEN
best soil for plants	DA
convert gmt to edt	DA
where to buy cupcake cakes	INFO
to clean leather sofa	DA
arterial stenosis symptoms	INFO
how to buy coins	BUY
64 bit computers	GEN
fireplace cover ideas	INFO
what is sage used for	DA
what is empirical research	DA
i need 10 facts on dolphins	INFO
facts about labradoodles	GEN
what can i feed my chickens	DA
yard of pea gravel	BUY
parts for jack lalanne juicer	BUY
usps rates flat rate box	NAV
minecraft servers to join	NAV
marble top tables	BUY
doppler test legs	GEN
how to get a car title loan	DA
heat rash treatment	DA
hummingbird wall art	BUY
how do i get rid of grubs	DA
how to do french manicure	DA
short prayers for meetings	INFO
what do morning doves eat	DA
a scavenger hunt list	RES
what causes feet swelling	INFO
prepaid smartphone	GEN
pictures of tree fungus	RES
cc to horsepower ratio	DA
fantastic sams coupons	RES
how to read a multimeter	DA
company mileage reimbursement	GEN
what is malaria disease	DA
perm for color treated hair	GEN
what is jaundice	DA
standard size of jelly roll pan	DA
loratadine 10	GEN
texas roadhouse recipes	INFO
cd rates at credit unions	DA
cost of structural engineer	BUY
what is a preposition word	DA
diagnosing meniere disease	GEN
hamburger patties	GEN
mini lops for sale	BUY
what is gram positive bacilli	DA
reasons for excessive gas	INFO
pool ph levels	GEN
everyday headache causes	INFO
colon cancer back pain	GEN
how much is a koi fish	DA
how to get red hair dye out	DA
how to keep snakes out of yard	DA
bone spurs in shoulder	GEN
low minimum mutual funds	GEN
what is a capstone project	DA
cardio glide exercise machine	BUY
apply for welfare canada	NAV
laser spine surgery ohio	INFO
medicaid rates by state	NAV
snowy owl enemies	INFO
gas flatulence treatment	INFO
where to buy kinder surprise	DA
berkshire stock split	GEN
airbag sensor	GEN
dragon fruit growing	DA
what country is bora bora in	DA
online credential programs	NAV
how to cure bells palsy	INFO
mystery shopper	GEN
how do i increase font	DA
what is the apple store number	DA
recipes with saltine crackers	INFO
how to control your diabetes	INFO
on off toggle switch wiring	GEN
tile for kitchen floor	GEN
does skinny d really work	DA
parent plus loan fafsa	GEN
all for one remote codes	INFO
arborvitae disease	GEN
how to clean a slate floor	DA
crossword puzzle solutions	RES
red dogwood tree	GEN
ringing on ears	GEN
expiration date on sunscreen	GEN
great pyrenees information	GEN
deepest part in the ocean	DA
top ten girl cat names	DA
different breeds of huskies	INFO
where to get mmr vaccine	INFO
white shark	GEN
coil pack wiring	GEN
cleaning tarnished silver	DA
how to plant juniper	DA
what is aerobic exercise	DA
when did world war 1 end	DA
mice repellent	GEN
what is angina pain like	DA
how do you tell a cat's age	DA
how to make survival bracelet	DA
tulsi holy basil plant	GEN
luma cream	GEN
croup contagious	DA
pain relief from hemorrhoids	INFO
aluminum wheel refinishing	GEN
walking after ankle surgery	GEN
seattle area zip code map	RES
free tattoo design websites	NAV
chrysler motors headquarters	GEN
reversible afghan crochet	DA
largest dinosaur found	GEN
what should pre diabetics eat	INFO
car door seals	GEN
play a piano on the computer	RES
pain in throat and ear	GEN
potpourri ingredients	INFO
what is broccoli good for	INFO
how to scrap a car	DA
convert kpa to psi	DA
are there snakes in ireland	DA
what is polyps in the colon	DA
what are signs of seizures	INFO
knee braces	GEN
what causes a dog to limp	INFO
what are closed end funds	DA
hunan chicken recipe	DA
what is a debutante ball	DA
homemade moss killer	DA
white blood cells elevated	GEN
how clean dryer vent	DA
what causes low blood sugar	INFO
quinoa calories	DA
what to do with a toothache	INFO
fertilizer organic	GEN
metastatic breast cancer	GEN
what is considered a high iq	DA
picture of sugar gliders	RES
ibs with constipation diet	GEN
how many carbs in a apple	DA
local harley davidson dealers	INFO
price of euro in dollars	DA
dragon fruit picture	RES
hammer toe exercises	INFO
junk yards toronto	INFO
valuable stamps	GEN
how to get out coffee stains	DA
how to make a arm sling	DA
black pudding	GEN
defibrillator heart	GEN
free aptitude test questions	RES
cat scan images	RES
chase pre approval	NAV
what is spartacus full name	DA
what color is iridium	DA
gaf shingle installation	DA
bank sort codes finder	RES
can post tracking number	NAV
recipe sauce for crab cakes	DA
when to plant runner beans	DA
cam money transfer	NAV
online wedding cakes	NAV
reset toshiba laptop	DA
check vin number for options	DA
bruised nail treatment	INFO
how to print document	DA
where to sell my tools	DA
flooring over concrete	GEN
how you quit smoking	DA
symptoms for cancer	INFO
physical exam form	RES
sign up instagram online	NAV
radiator cap diagram	RES
yellow sac spider	GEN
what is an echo stress test	DA
can am atvs for sale	BUY
kia sportage	BUY
lung cancer removal	GEN
word processor for apple	BUY
news on iraqi dinar	GEN
brothers of jesus	GEN
sample of a eviction notice	RES
adopt doberman puppies	INFO
hairstyles on your face	RES
hang on door mirror	BUY
free local hotlines	DA
coast guard reserve	GEN
oven roasted pork tenderloin	DA
diagnosis for meningitis	GEN
sim card for verizon phone	GEN
how do i get a ssl certificate	DA
earwax treatment	INFO
bougainvillea plant colors	DA
revocable trust after death	GEN
make laminate floors shine	DA
when world war two ended	DA
what is a modular home	DA
what is chia good for	INFO
plastic microwave bowls	BUY
grants to repair homes	GEN
los angeles county section 8	GEN
how to grow green onions	DA
how much are nissan skylines	DA
smartphones without contract	BUY
frogs for pets	GEN
poem for father to be	RES
organic vegetable garden	GEN
cna math practice test	RES
treatment blocked tear duct	INFO
group homes	GEN
pomeranian dog	GEN
bacterial infection on the face	GEN
unique voicemail greetings	GEN
how to make in cursive	DA
how to find triangle area	DA
lumbar surgery recovery	GEN
air compressor oil type	DA
types of pollution	INFO
how to pass compass test	DA
kids rocking chair	BUY
small garden lizards	GEN
rid a bug fogger	BUY
cadillac vehicles	BUY
replace bathtub drain stopper	DA
bone marrow biopsy needles	GEN
what area code is 866	DA
side effects of ovary removal	INFO
what is rooibos tea	DA
live finger monkey	BUY
home remedies poison ivy	INFO
what ginger is good for	DA
need for pacemaker	DA
evening oil of primrose	BUY
hardibacker cement board	BUY
sterilized milk	BUY
local baptist churches	INFO
dry kidneys causes	INFO
cinder block paint	BUY
cause of twitch under eye	INFO
laminate flooring tarkett	BUY
feeling tired after eating	GEN
credit and score	GEN
juice for arthritis	GEN
human resources university	GEN
cast iron manufacturers	INFO
what is asthma caused by	DA
fire bowl pit	BUY
list of starchy foods	INFO
how to keep stray cats away	DA
to delete all email	DA
rid of creeping charlie	DA
silver certificate 1957 a value	BUY
mississippi facts for kids	GEN
what are signs of dehydration	INFO
blue pit bull puppies for sale	BUY
cell phone boosters do they work	DA
frozen mussels	BUY
how muslims pray	DA
province crossword puzzle	NAV
how is a seizure caused	DA
paint job cost	DA
best 3d printers	DA
how to replace door	DA
top sunscreen for face	DA
mandee clothing store	NAV
bile ducts	GEN
perimenopause and symptoms	INFO
exercise after hysterectomy	GEN
bunkie boards for beds	BUY
cellulitis of the foot	GEN
family reunion invitation	RES
how to do medical coding	DA
best decongestant for kids	DA
symptoms of colic in infants	INFO
show millimeter ruler	RES
1 meter in inches	DA
itt tech courses	NAV
loan for unemployed people	INFO
installing a vinyl fence	DA
cyanuric acid salt water pool	GEN
what is a intersecting lines	DA
hormone levels for women	GEN
apply for government help	DA
fedex hours of delivery	NAV
causes of blood in eye white	INFO
polypropylene recycling	GEN
elevation of quito ecuador	DA
hydrangea endless summer	GEN
free legal forms	RES
unsubsidized school loans	GEN
invocation prayer samples	RES
foot exercises for heel spurs	INFO
ringworm on scalp symptoms	INFO
how to lower sugar naturally	DA
normal pulse blood pressure	GEN
examples outline format	RES
area code 855 is where	DA
flag etiquette united states	GEN
industry ratios	GEN
what causes deforestation	DA
geritol liquid iron	BUY
picture of foot corn	RES
acl and knee	GEN
cost of hemorrhoid surgery	DA
download gta vice city free	RES
game gta 5	BUY
make a rainbow	DA
pictures of baby possums	RES
how big is lake lanier	DA
property deed changes	GEN
how much is puppy shots	DA
milk thistle liver cleanse	GEN
what is variance in statistics	DA
boot camps in pa	INFO
funny limerick poems	RES
pacemaker battery life	GEN
what is toxins in your body	DA
can glutathione whiten skin	DA
free windows 8 update	RES
connect tv to computer	DA
ceus for nurses free	RES
neil armstrong family	DA
tile for bathroom	BUY
chronic afib treatment	GEN
what is male menopause	DA
mass in lower abdomen	GEN
the cause of bed bugs	DA
nectar	GEN
cures for inner ear infections	INFO
types of beetles	INFO
best ab workout	DA
things to pack for a trip	INFO
hair extensions for short hair	BUY
what do giraffes like to eat	DA
pictures of tattoos hearts	RES
orthopedic doctors in	INFO
stomach infection h pylori	GEN
college subjects	GEN
find my lucky numbers	NAV
writing business letters	DA
maned wolf facts	GEN
online goosebumps games	NAV
voodoo spells that work	DA
14x42 intex pool	BUY
zip code for bahamas	DA
driving record illinois	NAV
stephen sinatra books	DA
how to shine terrazzo floors	DA
goldendoodles	GEN
getting rid of warts at home	DA
heart failure swollen feet	GEN
antarctica animals pictures	RES
how to treat powdery mildew	DA
mobile home floor repair	BUY
does lice treatment kill nits	DA
what causes colon blockage	DA
death by cancer statistics	RES
preparing for an job interview	DA
how to kill grubs in my lawn	DA
arthritic knee braces	BUY
living with copd	GEN
word search free puzzles	RES
1936 buffalo nickel e value	BUY
lowe hours of operation	NAV
change default web browser	DA
template of cover letter	RES
how to pass the mmpi test	DA
benefit of cinnamon tea	DA
eye test card	RES
amberjack fish	GEN
capital of oregon	DA
list of polar solvents	DA
how do i get cervical cancer	DA
road bikes sizing	GEN
dot exam forms	RES
uses of linseed	INFO
colon test kit	BUY
potassium gold cyanide	GEN
exercise for foot pain	GEN
what is a flow chart	DA
cancer markers in blood	GEN
1090 form download	RES
what foods lower cholestrol	DA
homemade roach poison	DA
value old pennies	BUY
glucosamine msm side effects	INFO
where is my state tax return	DA
travelers check purchase	BUY
gluten intolerance treatment	INFO
hummingbird diet	GEN
costco coupon code	NAV
tetanus vaccine for adults	GEN
nocti practice test	RES
micro braids prices	BUY
how to clean brass easily	DA
basement ceiling systems	GEN
sepsis infection in the blood	GEN
value of old foreign currency	BUY
side dishes for shrimp	INFO
bike tire sizes chart	RES
pulmonary hypertension	GEN
what is indiana state animal	DA
world war i facts	GEN
small enclosed trailers	BUY
causes of internal bleeding	INFO
what is video capture card	DA
how to cut asparagus	DA
lvnv funding llc contact info	NAV
which lizards are poisonous	DA
ge universal control codes	RES
truck bed rails	BUY
michaels crafts website	NAV
used dually truck	BUY
glass sliding door blinds	BUY
what is computer cache	DA
what is good blood pressure	DA
family coat of arms search	RES
cast iron skillet care	GEN
drivers without insurance	GEN
safety ratings on suvs	INFO
release date of inmate	GEN
become a talent agent	DA
how does a pacemaker work	DA
idea for bridal shower	INFO
bat bites in humans	GEN
what is low vitamin d	DA
birthday gifts for wife ideas	INFO
suez canal map	RES
wrench sizes in order	INFO
ovation for hair growth	BUY
concrete floor paint reviews	BUY
lyrics for poems	RES
what is the zip 4 code	DA
high platelets cause	DA
unscramble letters	RES
free paint by number	RES
how to measure a gram	DA
abdominal aortic ectasia	GEN
comfort hybrid	BUY
turmeric supplement	BUY
asthma what causes it	DA
free printable food diary	RES
how to treat pneumonia	DA
what is a sim card	DA
convert kilograms grams	RES
what causes bright yellow urine	DA
onion sets when to plant	DA
what is autism symptoms	INFO
flying squirrels in the attic	GEN
how to read stock quotes	DA
how to fix a generator	DA
how to apply for state grants	DA
shingles more than once	DA
iraqi dinars news	NAV
get out of student loan debt	DA
how do you tweet someone	DA
dyslexia test kids	RES
mrsa carrier symptoms	INFO
what is the factors of 27	DA
what does a tick bite look like	DA
can you get shingles twice	DA
reading tabe test	RES
iowa facts	GEN
information on phone number	GEN
cab air suspension	GEN
psoriasis foods to avoid	INFO
outback sangria recipe	DA
monster battery charger	BUY
what do nurse practitioners do	DA
fedex package delivery	NAV
team fortress 2	BUY
liters equals gallons	DA
loans with collateral	GEN
steps per mile	DA
antique mantel mirrors	BUY
will honeywell stock split	GEN
diet for lung cancer	GEN
when plant strawberries	DA
stearns and foster mattresses	NAV
how electric cars	DA
sauce for ravioli	DA
knee orthopedic	GEN
liver spots on skin causes	INFO
publix store in in	INFO
blue heeler dog breed	GEN
chain link fence cover	BUY
curtain draw rods	BUY
power lawn rake	BUY
what is termite inspection	DA
volkswagen epc light	BUY
how to reduce bruising	DA
xbox 360 guitars	BUY
2008 mustang gt horsepower	DA
remove moss	DA
medical benefits of papaya	INFO
print photo postcards	DA
what do dog worms look like	DA
best gifts for 50th birthday	INFO
ventless fireplaces	BUY
tattoo designs names	RES
nvc case number check	NAV
cox customer service number	NAV
hairstyles for double chins	RES
gutter repairs	INFO
water powered clock	GEN
thoracic aorta ectatic	GEN
elizabethan fine bone china	BUY
how do i get rid of hornets	DA
close apps	DA
tabe test sample questions	RES
what is orzo pasta	DA
tortuous colon causes	INFO
colon lesions	GEN
remove windshield scratches	DA
fruits low in carbs and sugar	INFO
how to build basketball court	DA
daily dose of vitamin d	DA
coke vs pepsi	INFO
celery salt	GEN
how to rid house of spiders	DA
boot camps for kids	INFO
facts on global warming	GEN
can copd cause death	DA
how to grade percentage	DA
pictures of a havanese dog	RES
social security form ssa 561	RES
who sells gluten free bread	BUY
federal inmate photos	RES
remove dog odor	DA
gestation period of a sheep	DA
all parts of the human body	GEN
how are boats made	DA
what are side effects of niacin	DA
respite care for children	INFO
holley carburetors for sale	BUY
terminal cancer symptoms	INFO
where can i buy contacts	DA
pay my verizon bill by phone	DA
catheter ablation	GEN
how to build a patio	DA
tumor in lungs symptoms	INFO
the symptoms of dengue fever	INFO
plantar faciitis treatment	INFO
how to install exterior door	DA
where to get cdl book	DA
check cashing store	INFO
apply for food stamps texas	NAV
volleyball poles	BUY
statistics of lung cancer	INFO
bacterial meningitis pictures	RES
verizon rebate card	NAV
a list of good manners	INFO
affidavit for child custody	RES
remedies for poison ivy itch	INFO
live pygmy goats	BUY
section 8 what is	DA
diabetic snacks list	INFO
liters to millimeters	DA
punctured lung treatment	GEN
what causes blurred vision	DA
install ceramic floor tile	DA
motorcycle online course	NAV
best fertilizer for watermelons	DA
how do lines of credit work	DA
powder coating costs	BUY
facts about box turtles	GEN
reclaimed wood for sale	BUY
buy bitcoins using credit card	BUY
what does iron do	DA
free cna practice skills test	RES
keyless entry remotes	BUY
laser spine surgery reviews	BUY
make tissue paper flowers	DA
heavy duty clothesline	BUY
carpal tunnel hand exercises	INFO
hanging fireplace	BUY
test for iodine deficiency	INFO
names in bubble letters	RES
dairy farming	GEN
certified forklift training	INFO
how do i build a closet	DA
b complex side effects	INFO
is brown sugar good for you	DA
west nile virus symptoms	INFO
arctic atv parts	BUY
pics of cellulitis infection	RES
cure for itchy feet	INFO
lowering ph in water	DA
discount sauder furniture	NAV
what plants grow in shade	DA
guardian dental plan benefits	NAV
real silver flatware	BUY
federal inheritance tax rate	GEN
eliminate acne scars	DA
school for flight attendant	INFO
neem tree leaves	BUY
checklist for first apartment	RES
entry level it jobs	INFO
what is maracuja oil used for	DA
nail polish zoya	NAV
verizon international	NAV
button turp procedure	GEN
find square footage	DA
what is alaska	DA
free 30 day notice letter	RES
hunter sprinkler heads	BUY
easy recipes for meatloaf	INFO
shower rods	BUY
gmc sierra specs	NAV
popular rss feeds	INFO
eenadu today news	NAV
shih tzu puppies for free	BUY
discipline for toddlers	GEN
how do i get daycare license	DA
lkq parts locator	NAV
bag display rack	BUY
battery boat lights	BUY
vegetables with high iodine	INFO
what are the patients rights	DA
what is low glycemic food	INFO
when to transplant roses	DA
an alkaline diet	GEN
become a surrogate mother	DA
what is mm in cm	DA
best endocrinology doctors	INFO
synapses	GEN
causes of hiccups in infants	INFO
picture of recluse spider	RES
pomeranian poodle puppies	BUY
stop credit cards	DA
facts on president lincoln	GEN
view browsing history	DA
behr colors	NAV
top 10 bicycles brands	DA
payment terms for invoices	INFO
degree in microbiology	GEN
how do you get rid of a cold	DA
what is leavened bread	DA
first signs of diabetes	INFO
dui laws in ga	GEN
cause of excessive sweating	DA
can you give rabbits baths	DA
eyeglasses medicaid	NAV
exercise for thoracic spine	INFO
shoulder joint injections	GEN
inflamed sinus treatment	GEN
measuring cup measurements	INFO
left renal cyst	GEN
sesamoid bone in foot	GEN
9 year anniversary gifts	INFO
the price of used cars	BUY
how to grow pomegranates	DA
spousal survivor benefits	INFO
what kills creeping charlie	DA
math classes	GEN
minecraft desktop background	RES
benefit of licorice	DA
how to get business tax id	DA
sodium chloride used for	DA
poems for new mothers to be	RES
poem statue of liberty	RES
yeast allergies symptoms	INFO
what causes acne	DA
is aspirin a blood thinner	DA
the korean war	GEN
river thames map	RES
how to multiply exponents	DA
black mustard seed	GEN
airplane design for kids	GEN
salary of a graphic designer	DA
terrazzo floor polish	BUY
spinal injection for back pain	GEN
tachycardia symptoms	INFO
wheelbarrows parts	INFO
chevy 350 engine firing order	DA
best natural hair dye for men	DA
corpus callosum	GEN
oxygen ozone therapy	GEN
diabetes insipidus symptoms	INFO
high wbc count causes	INFO
symptoms of dust mite bites	INFO
what is tenants in common	DA
why is breakfast important	DA
oxygen levels dangerous	INFO
how to do a radon test	DA
how to wire a starter relay	DA
how much weight is a ton	DA
what prevents mosquito bites	DA
osha forklift test	RES
kitchen remodel checklist	RES
what to eat when constipated	DA
treasure hunt clues	INFO
why is my period a week early	DA
leed certification	GEN
what is brain fog	DA
what is an ulcer in stomach	DA
wage and labor laws	GEN
how to know my fertile days	DA
culligan water softener prices	BUY
how do i turn on cookies	DA
how to treat a uti at home	DA
forms of energy	GEN
how to trim bamboo plants	DA
silver hair color dye	BUY
how to tighten skin naturally	DA
time warner phone numbers	NAV
the liberty bell location	DA
mini goldendoodles for sale	BUY
foods that cause joint pain	INFO
pictures bed bugs rashes	RES
causes of orbital cellulitis	INFO
freightliner diagnostic codes	RES
instagram video app	RES
mucus in the stomach	GEN
where is st lucia	DA
cost of a pool	DA
hemp products	GEN
curb weight trucks	INFO
afghan patterns to crochet	RES
basement wall waterproof	INFO
how does a thermostat work	DA
leukemia cml survival rate	DA
carbohydrates in broccoli	DA
happy wheels all games	NAV
auto refinance bad credit	DA
polymyxin b sulfate eye drops	GEN
free cpn number	INFO
coricidin cough syrup	BUY
what is myeloma bone cancer	DA
kitchen cabinet refacing cost	INFO
real hoverboard for sale	BUY
repair swimming pools	INFO
100th birthday gift ideas	INFO
price of sulfur	BUY
door torsion spring	BUY
staph infection in blood	GEN
what causes a fast heart rate	INFO
recovery after angioplasty	INFO
the best creatine	BUY
hemangioma liver	GEN
mast cell disease	GEN
sample of pardon letter	RES
baby blanket size	DA
ideal humidity in basement	DA
akc small dog breeds photos	RES
carbs per day for diabetics	DA
convert watts to kva	DA
user guide manual	RES
wiccan beliefs	GEN
what is function of heart	DA
how do i treat a bed bug bite	DA
photos sri lanka	RES
epidural for back pain	GEN
birthday hillary clinton	DA
maf sensor symptoms	INFO
hidden word puzzles	RES
osteoarthritis of feet	GEN
what is calamari	DA
vitamin b complex for kids	GEN
what to do for wasp bite	DA
why do dogs eat grass	DA
outgoing call block	DA
phone country code usa	DA
what is golden staph infection	DA
9th grade math answers	RES
pokemon cards to print	RES
medical crossword puzzles	RES
high ra factor	GEN
treatment for hip labral tear	INFO
who can qualify for medi cal	DA
hair bows how to make	DA
how to do concrete steps	DA
get cdl fast	INFO
about dental hygienist	GEN
normal bmi for men	DA
venous reflux treatment	INFO
the porsche cayenne	BUY
us mail flat rate box prices	BUY
what is ph levels	DA
prices of savannah cats	BUY
tomato is a fruit because	DA
wonderword daily puzzle	RES
curing heartworms in dogs	GEN
common allergy symptoms	INFO
youth poems for church	INFO
what foods increase hdl	DA
creams for eczema	INFO
calculate my gpa college	DA
what is a lesion on the spine	DA
how keep chipmunks away	DA
work bench grinder	GEN
how to apply for turkish visa	DA
why do i sweat so much	INFO
how to send a email	DA
military payment certificates	GEN
how to invest in silver	DA
acid reflux what not to eat	DA
what does high folate mean	DA
how to write a grant	DA
florida islands for sale	BUY
wall partition	BUY
where can i buy monin syrups	DA
aleve products	BUY
order kitchen cabinet doors	BUY
all samsung mobile phones	BUY
what is a tsh blood test	DA
what is a whipple procedure	DA
images of mosquito bites	RES
daybed queen size	DA
fern michaels series book list	INFO
what causes asperger syndrome	DA
ignition key will not turn	GEN
different computer viruses	INFO
to stop nail biting	DA
how to reverse gray hair	DA
sample of eviction notice	RES
curb weight of vehicles	GEN
fluttering feeling in chest	GEN
dry eye treatment for dogs	INFO
high tide and low tide today	DA
school bus driver job	INFO
connect a laptop to a tv	DA
hairstyles short fine hair	RES
social security form ssa 1724	RES
liposuction for double chin	GEN
blood clot treatments for leg	INFO
what is contouring makeup	DA
low income housing grants	INFO
ibs probiotics	GEN
security guard training course	INFO
installing a gfci outlet	DA
treatment for bug bites	INFO
explain a neutral wire	DA
cell phone tracer	GEN
yogurt dip for fruit recipe	DA
recipe for dip for fruit	DA
price of veneers per tooth	DA
directions to lake mead	RES
how send money	DA
pay stub copy	GEN
yellow pages phone no	RES
leukemia cll life expectancy	DA
crank position sensor location	DA
blood test for bone marrow	GEN
sell antique rugs	DA
knock out roses lowes	BUY
code of ethics for teachers	GEN
cold air return vents	BUY
verbena perennial	GEN
dia de los muertos mexico	GEN
free printable calendar	RES
to apply makeup	DA
colon polyps pictures	RES
cooking corn in microwave	DA
car history report	GEN
amelia island map	RES
spinal meningitis pictures	RES
what are symptoms of malaria	INFO
double pane windows	GEN
how to plant ivy	DA
nutrition facts of quinoa	DA
cost per kwh electricity	DA
examples of false dilemma	INFO
soy lecithin supplements	GEN
liens on cars	GEN
mini goldendoodle puppies	BUY
what is ganoderma lucidum	DA
side effects of a beta blocker	INFO
tsh normal	DA
when are tomatoes in season	DA
tattoos pictures	RES
scarab jet boats	BUY
smelly drains kitchen	DA
pregnancy girdle	BUY
mitral valve prolapse fatigue	GEN
harp home loan	NAV
is banana good for diabetics	DA
different palm trees	INFO
magic the gathering card	BUY
what country is jamaica in	DA
social worker college	INFO
bill payment online airtel	NAV
medicare cover	NAV
magnesium for sleep aid	GEN
circuit breakers square d	BUY
band surgery	GEN
torn meniscus exercises	INFO
pictures of bakers cysts	RES
fedex home delivery tracking	NAV
swiss chocolate brands	INFO
simple magic tricks	INFO
irs form schedule k 1	RES
average electricity costs	DA
when is bluefin tuna season	DA
converter catalytic	GEN
529 college savings plan	GEN
ringing in ear	GEN
serum cholesterol level	GEN
tennis shoes rated	BUY
exercise for sore shoulder	INFO
1950 schools	GEN
homemade hair dye recipe	DA
what is sleeve gastrectomy	DA
ink out of clothes	DA
how to refill cartridges	DA
how much to feed your dog	DA
recovery from broken pelvis	GEN
about computer networking	GEN
how do i update my browser	DA
diy weed killer	DA
how to get pet monkey	DA
blinds inside windows	GEN
milk thistle dosage	DA
value of euro to us dollar	DA
foods low in sugar and carbs	INFO
how to type emoticons	DA
cbc w diff blood test	GEN
how to cure depression	INFO
stomach tumor	GEN
shih tzu health problems	INFO
power inverter generator	GEN
side effects to probiotics	INFO
inexpensive garden ideas	INFO
va compensation benefits	NAV
freight class nmfc	NAV
corner trim molding	GEN
late fee calculator	RES
epididymitis	GEN
bunion surgeries	GEN
low glycemic bars	BUY
where is my favorites list	DA
varieties of okra	INFO
crochet edging patterns free	RES
what is an anecdote	DA
abdominal pain right side	GEN
fruit that starts with e	INFO
easy borscht recipe	DA
benefits of okra for diabetes	INFO
medical aesthetician school	INFO
low residue low fiber diet	GEN
home soil testing	GEN
keep dogs out of flower beds	DA
what is a civil engineer	DA
carpet protectors	BUY
graco parts replacement	BUY
spine cancer prognosis	DA
removing wall paneling	DA
tension springs	GEN
symptoms of b12 deficiency	INFO
free wii downloads	RES
world most expensive perfume	DA
swollen leg causes	INFO
what is 600 denier nylon	DA
what to do for dog arthritis	INFO
weber replacement parts	BUY
field mice repellent	BUY
missouri major industries	INFO
mri results	GEN
what causes strep b	INFO
check my visa status nvc	NAV
allergy causes	INFO
high t4 low tsh	GEN
mini lab puppies	BUY
respite care workers	GEN
shoe sizes us to uk	DA
pictures of respiratory system	RES
dc to dc power converters	BUY
life cycle of a cicada	INFO
virginia 529 plan	GEN
horsetail for hair growth	BUY
wildflower names list	INFO
natural toenail fungus cures	INFO
first aid certification	INFO
cost of a ragdoll cat	DA
ideas for a 40th birthday party	INFO
a list of complex sentences	RES
outside gfci outlet	GEN
water shut off valve handle	BUY
mango tree diseases	INFO
colonoscopy side effects	INFO
waterbed heaters for sale	BUY
mexico is north america	DA
value of 1921 silver dollar	DA
how to cook a whole trout	DA
square inches	GEN
where to sell silver flatware	DA
popcorn removal cost	BUY
the eiffel tower in france	GEN
eye makeup for asian eyes	INFO
liquid grass seed	BUY
how to make shelf	DA
causes of red blotchy skin	INFO
mummies facts for kids	INFO
lesions on the bone	GEN
channel five news new york	NAV
how do i get rid of wasps	DA
how to make a list	DA
what causes fast heart rate	INFO
i need a tax id number	RES
symptoms of parvovirus	INFO
play super mario bros 2	BUY
eyelid doctor	GEN
dosage for vitamin b12	DA
hedge trimming	DA
what is the annual fica limit	DA
guide to write a resume	DA
how to replace radiator	DA
zip and postal codes	GEN
how to install shocks	DA
eye makeup pictures	RES
what are root vegetables	DA
border terriers	GEN
hydrangea care	GEN
door curtain rods	BUY
suggested diet for gallstones	DA
powdery mildew	GEN
collect social security at 62	DA
phone number time warner	DA
noritake patterns	RES
itching all over my body	GEN
bottom of door seal	BUY
200 gallon propane tank	BUY
wrong fuel in car	DA
motion porch light	BUY
cause of swollen eyelids	INFO
the world tallest building	DA
what causes a stomach ulcer	DA
apply for calworks	NAV
white marks on toenails	GEN
lupine flower seeds	BUY
how to make extra money	DA
popular foods in the 1960s	INFO
metric conversion chart	RES
pacemaker and defibrillator	GEN
does butter contain gluten	DA
opm retirement benefits	DA
large flat rate box usps	NAV
blood iron levels	GEN
lemon sherbet ice cream	DA
pressure treated wood prices	DA
how to i patent an idea	DA
thyroid uptake and scan	INFO
what causes ibs	DA
best ovulation test	DA
pictures of huntington disease	RES
size of king size pillowcases	DA
ear mites in dogs treatment	INFO
baby shower drinks	INFO
shoe dye	GEN
pizzas hut coupons	RES
auto carpet repair	DA
how to build an aquarium	DA
free easy knitted hat patterns	RES
best bed bug repellent	DA
poem for 80th birthday	RES
anonymous text to phone	RES
left side of the brain controls	DA
milliliters in a teaspoon	DA
homemade deer repellent	INFO
barberry red	GEN
tin search by number	NAV
2 dollar bill with red 1953	GEN
women hormones	GEN
how to check a dc motor	DA
current cost of living	DA
what is apa writing format	DA
amphibians animals list	RES
arabic coins value	BUY
best liquid multivitamins	DA
o positive blood type diet	INFO
white spots on plants	GEN
free dental service	INFO
bad breath remedy	INFO
cure for kidney failure	INFO
transmission shifting problem	GEN
easy plant identification	RES
shunt surgery brain	GEN
gmac financial services	NAV
damage to left side of brain	GEN
interior door shutters	BUY
how to match colors	DA
skin fungus remedies	INFO
look up dea number	RES
vintage homer laughlin china	BUY
what is a call and put option	DA
forensic science courses	INFO
speed sensor symptoms	INFO
roll a way beds	BUY
grafting citrus trees best time	DA
food without carbohydrates	INFO
infant lesson plans	RES
closed end funds	GEN
how to use slippery elm	DA
traditions of culture	GEN
foods good for pancreas	INFO
mop a floor	DA
how to grow avocado tree	DA
advocare ingredients	DA
find my coat of arms	DA
hybrid oak trees	GEN
best suv under 20 000	BUY
coventry health plans	NAV
what is in tums	DA
rescue toy poodles	INFO
septic tank specifications	INFO
junk yards in philadelphia	INFO
how to make hair grow	DA
1 cent stamp value	DA
repaint kitchen cabinets	DA
business ethics articles	RES
how to take ubiquinol	DA
torn tendon in arm	GEN
health benefits of chaga	INFO
locust tree diseases	INFO
45 day notice to vacate	GEN
bitter melon is good for what	INFO
normal respiration rates	DA
facts about a sloth	GEN
how to treat sore gums	INFO
free ambigram generator	RES
sacrificial magnesium anodes	GEN
fram air filter part numbers	NAV
long menstruation	GEN
growing vegetables indoors	DA
what are hormones	DA
steps to equal a mile	DA
insulation for garage walls	BUY
basic algebra for beginners	GEN
how to obtain a police report	DA
quartz tiles floor	GEN
symptoms for lyme disease	INFO
what causes red ears	INFO
where is christmas island	DA
ginseng extract benefits	INFO
vanadium for diabetes	INFO
how do i figure square feet	DA
impound lots	INFO
fifth grade spelling word list	RES
the types of family	INFO
what is my post code	INFO
type t light bulb	BUY
free usa crossword puzzle	RES
nervous system problems	INFO
new born baby	GEN
swollen lymph glands in neck	GEN
male cat names unique	INFO
arched curtain rods	BUY
church bulletin templates	RES
normal magnesium levels	DA
puk codes for samsung	RES
what size is 29 in usa	DA
jet ski deals	BUY
finger tip oximeter	BUY
normal blood calcium levels	DA
porcelain identifying marks	INFO
which is the best printer	DA
gmod game download	RES
search word search puzzles	RES
evicting a family member	DA
health benefits of beets	INFO
red dots under skin on legs	GEN
monthly expense spreadsheet	RES
cerebral vascular disease	GEN
boot camps in texas	INFO
what causes large pupils	INFO
blocked carotid symptoms	INFO
picture of 45 degree angle	RES
different size propane tanks	INFO
what is flax seed good for	INFO
project charters examples	RES
chemo patient recipes	INFO
what is croup cough in adults	DA
how many quarts in one gallon	DA
how does lyft work	DA
map key legend	RES
rare retired ty beanie babies	BUY
bridal shower best wishes	GEN
cyst of the pancreas	GEN
light headed dizzy symptoms	INFO
native ribbon shirts	BUY
left side of neck swollen	INFO
shetland sheepdog breeders	INFO
pfister faucet repair	INFO
how to sharpen a chainsaw	DA
lose weight quick	DA
make a toy car	DA
what do lice eggs look like	DA
how to stop heart palpitations	DA
deed records	GEN
dmso pain relief	GEN
reversing clogged arteries	DA
check status foid card	NAV
plants vs zombies 2 game pc	BUY
rent affidavit form	RES
ounces to milliliters	DA
saline solution nasal spray	GEN
birthday ideas for girlfriend	INFO
cause of sinus infection	INFO
what is coefficient	DA
will iraqi dinar revalue	DA
loss program weight	GEN
immigration san antonio texas	GEN
blue book for corvettes	NAV
prognosis of thyroid cancer	DA
breeding age for heifers	DA
carbs in quinoa	DA
best soundbar for tv	INFO
job description for a welder	DA
1943 us penny value	DA
how to grow huge pumpkins	DA
how to mount a tv	DA
collateral loans on vehicles	GEN
capital bogota	GEN
car outlet inventory	GEN
free documents bylaws	RES
creatine diabetes	GEN
crops grown in indiana	GEN
class 5 gravel	GEN
att to go	NAV
automobile power windows	BUY
heat smart	NAV
2 1 1 mississippi	NAV
causes of headaches in women	INFO
hot clothing brands	INFO
cool pencils	INFO
dialing 112 on cell phone	GEN
final match world cup	GEN
calories for salmon fillet	DA
18k gold chains	BUY
extension leads	BUY
algae culture media	GEN
atlantis pool liner	BUY
fun skits	GEN
american soaring association	GEN
dvd drive troubleshooting	INFO
coconut and cholesterol	GEN
family of maya angelou	GEN
facts about number six	GEN
brown discharge between periods	GEN
dws funds mutual	GEN
canadian border	GEN
ham delights recipe	DA
facts about major depression	GEN
fictitious name list	RES
advertising in real estate	GEN
how to be on a tv show	DA
a world of bathrooms	NAV
acupuncture for smoking	GEN
house prices actual	BUY
arlington school district	GEN
free movie portal	NAV
how can i be happy	DA
biotherm lip balm	BUY
card holders for weddings	BUY
computer drafting and design	GEN
brazil bank	NAV
fun summer places for kids	INFO
cadillac head gasket	BUY
all midnight club games	BUY
field mice in my house	DA
dual voltage	GEN
california duplexes for sale	BUY
funny sentence quotes	INFO
electronic business cards	GEN
houston real estate listings	BUY
60 66 chevy truck parts	BUY
anitas acrylic paint	BUY
happy christian poems	RES
flights to australia	BUY
friendly ice cream cake	NAV
dc jeans	NAV
how can you prevent swine flu	INFO
herbs for ear infection	INFO
clearance interior doors	BUY
for sale buick	BUY
ekg ruler	GEN
cell phone tower design	GEN
buy xango juice	BUY
free online art games	RES
how to balance a tire	DA
all types of nursing	GEN
animals that are reptiles	GEN
administrator of the estate	GEN
baked grouper fillet recipes	DA
haul master trailer	BUY
dog chow food	BUY
famous city names	INFO
bike basket for dog	BUY
doctorate in sociology	GEN
awning roll up	BUY
document camera	BUY
blues love songs	INFO
elvis song my way	RES
hollywood bollywood	GEN
gas fireplaces prices	BUY
how much is a server	DA
create a poster	RES
coffee drinks with alcohol	INFO
herb drying cabinet	BUY
glue suppliers	INFO
concession stand jobs	INFO
elwood indiana map	RES
anytime gym cost	BUY
horses for free in sc	BUY
country meat market	NAV
bookshelf glass	BUY
certified saturn service	NAV
graco pack n play instructions	RES
how much is post stamp	BUY
ask siri questions online	NAV
1999 jeep cherokee classic	BUY
chevy cavalier wagon	BUY
best over the counter glycolic peel	BUY
basic transport allowance	GEN
cost of building deck	BUY
how to make a snake cake	DA
axs tv charter cable	BUY
family allowance quebec	GEN
change telephone number	GEN
crb index symbol	RES
armchair fitness for seniors	GEN
food online store	NAV
chemical peel phenol	GEN
care for chihuahua	GEN
amistad movie online	RES
healthy drinks for kids	INFO
crab muffins recipe	DA
daughters of lot	GEN
film television auditions	GEN
10 minute meals	INFO
how do i create a zip file	DA
how to can salmon recipes	DA
good applications for ipad	DA
brocade fabric by the yard	BUY
combat defense squadron	GEN
hidden personality test	RES
how to extend a fence	DA
gas gauge indicator	GEN
amazon login in	NAV
breaking maine news	NAV
aqua quartz pool filter sand	BUY
furniture stores in roanoke	BUY
avon soft skin	BUY
classroom history posters	BUY
120v hot tub	BUY
flat bottom bowls	BUY
Cuba Travel From Canada	INFO
fastest car in world 2014	DA
construction cost estimate	BUY
all recipes round steak	INFO
2 x 6 steel studs	BUY
harvesting mint	DA
find truck drivers free	DA
delta air luggage	NAV
how to make a beaver costume	DA
ebay 90 off	NAV
fiscal office	GEN
dexter showtime schedule	RES
borders phone number	NAV
basilica washington dc	GEN
childrens school reading books	BUY
free wap sites	NAV
hotsy steam cleaner	BUY
guest log book	BUY
how to have a green lawn	DA
chevy six cylinder	GEN
first niagara hours	NAV
hollywood houses for sale	BUY
all purpose gravel	BUY
22 in wheels	BUY
1 axle trailer	BUY
downdraft wood stove	BUY
bathroom suites	GEN
city of austin city limits map	RES
honda wheels	BUY
gold weight calculator	RES
best set of irons	DA
area restaurants	INFO
Auto Parts Supermarket	NAV
affymetrix data analysis	NAV
alaska milk prices	INFO
100 inch screen	GEN
black on black hat	BUY
bob hairstyle images	RES
clippers to shave head	BUY
how to sell a call	DA
face doctor	GEN
dance awards	GEN
convert volts to microvolts	DA
apartment for rent vancouver	BUY
cream bread box	BUY
data plan cost comparison	DA
best quality shingles	DA
audio media	GEN
days of our lives jack	GEN
burlington bail bonds	NAV
home gym small space	GEN
how to make a dirt cake	DA
car shipping charges	BUY
ford focus fog lights	BUY
626 watch battery	BUY
bellbrook high school	NAV
funny printable cards	RES
extension online training	NAV
ear dryer walmart	BUY
chicago wheat prices	DA
attorney at fact	GEN
hog	GEN
bi intelligence	GEN
how to make purses and bags	DA
aquarium gravel	BUY
building maintenance tech	GEN
art and design careers	GEN
brown and green wedding	GEN
can i work with shingles	DA
filling machines	BUY
210 highway	GEN
colorado dental plans	GEN
air show tickets	BUY
find salary comparisons	RES
diesel brand	GEN
aristotle elements	GEN
arrest records miami	RES
box stock project	NAV
apartments for rent in madrid	BUY
how to build a grill	DA
compare used car prices	DA
drought grass seed	GEN
banks on long island new york	INFO
algebra balance scales	GEN
business postcard templates	RES
easy wok recipes chicken	INFO
at home wrinkle treatments	BUY
adenomyosis of the uterus	GEN
emergency housing florida	GEN
billy graham ministries	NAV
area code 348	DA
century wire	NAV
b and d used cars	NAV
cutco cookware review	BUY
20th anniversary silver	GEN
altar boy uniform	BUY
graviola plant	GEN
free apps for 3g iphone	RES
gentiva university courses	NAV
bam marine parts	NAV
easiest pie crust	DA
anchorseal wood sealer	BUY
conway tractor supply	NAV
free video movies now	RES
drag race engines	GEN
australia cruise lines	GEN
early stage mouth cancer	GEN
fax to united states	GEN
chair swivel plate	BUY
fat free fryers	BUY
germany family traditions	GEN
fee for immigrant visa	DA
fabulous dessert recipes	INFO
elegant lamps	BUY
fundraising proposal sample	RES
health tools	NAV
best airline deals right now	BUY
hosting managed services	GEN
difference in internet speeds	GEN
drilling stainless steel	DA
Accounts Payable Process	GEN
1972 dollar	GEN
220 voltage	GEN
gas turbine generator	GEN
falcon door closer	BUY
dating for introverts online	NAV
corel graphic	BUY
free website thumbnails	RES
hemingway novels	INFO
how old is jennifer lopez	DA
blountville elementary school	NAV
food tracker usda	RES
billionaire dating sites	NAV
8x10 area rugs	BUY
chicago il attractions	INFO
air handler air filters	BUY
dump pick up	GEN
all the spanish verbs	GEN
american studies	GEN
connect to cox	NAV
dora grows up	BUY
create a charter account	RES
high carb fruit	INFO
california science standards	GEN
cooler sizes	INFO
chow baby coupons	RES
baers furniture miami	NAV
barcode scanner parts	BUY
channel five boston	NAV
clutch kit	BUY
birthday party games online	RES
carbon monoxide sensor	BUY
copic ciao or sketch	BUY
after halloween sales	INFO
group 1 dealerships	NAV
how to lead a pipe	DA
4 prong trailer plug	BUY
dictionary: husky	RES
cracked macbook pro screen repair	DA
bakken mutual fund	GEN
exide battery warranty	GEN
greenlight die cast	BUY
black and red hair	RES
edge tiles	BUY
connecticut furniture	INFO
expensive bikes	GEN
beekmantown middle school	NAV
house for sale in rockville	BUY
fix my phone nyc	NAV
change feet into inches	DA
cheapest car parts	BUY
fizz soda maker	BUY
avocado dip guacamole	DA
battery for samsung exhibit	GEN
bicycle sprocket sizes	DA
cute baby shower appetizers	INFO
buy outre hair	BUY
cuba mail	GEN
dr pepper sponsorships	NAV
family resorts in pa	INFO
holiday letter template	RES
bone strength exercise	GEN
250cc motorcycle scooter	BUY
how much is a ragamuffin cat	DA
how to make a long island	DA
high performance fuel filters	BUY
fagor pressure fryers	BUY
hockey in schools	GEN
air filter unit	BUY
100 science projects	INFO
how to build a wood arch	DA
best wrist watches	DA
atkins diet sugar alcohol	GEN
dubaj last minute	GEN
elvis photo album	BUY
auravie free trial offer	BUY
how to install duct wrap	DA
how to sell an app	DA
craigslist vancouver wa	NAV
chinese prediction gender	GEN
different types of diamonds	INFO
flash flash cards	NAV
babiesrus discount codes	RES
chatham home builders	NAV
davita core values	GEN
home mold test kit reviews	NAV
glutathione sources	INFO
best putter 2014	DA
cloisonne antique clock	GEN
buy timex watch	BUY
conveyor trucks for sale	BUY
book airmiles flight	BUY
chevy engine timing marks	GEN
china trip deals	BUY
hasbro games hasbro	NAV
how to clean blood from fabric	DA
chicago illinois real estate	BUY
diy check valve	DA
contemporary furniture decor	INFO
erie cemetery erie pa	GEN
asymmetrical objects	GEN
convicted felon	GEN
czech recipe book	RES
city of houston address	DA
event recorders	GEN
dacor refrigerator reviews	NAV
history washington state	GEN
heavy bag workout	GEN
hairstyle 2014 trends	INFO
how are orchids grown	DA
financial demographics	GEN
commercial meat slicer used	BUY
best finance calculator	DA
free photography catalogs	RES
death	GEN
assurant provider directory	RES
cover girl mascara	BUY
download flash plug in	RES
advertising with coupons	GEN
home dust control	GEN
free garden rocks	BUY
daily routine app	RES
dirt racing bikes	GEN
carpets used	BUY
color coordination chart	RES
aeg built in ovens	BUY
cub cadet 2146	GEN
how are canyons made	DA
how to grooming dogs	DA
bump it hair in stores	BUY
el salvador lawyers	INFO
bulk cherry pits for fuel	BUY
gray insurance	NAV
embroidered uniforms	GEN
gamma linolenic acid	GEN
edgar painting	GEN
capresso thermal coffee maker	BUY
american history people	GEN
how consolidated credit works	DA
garden art with dishes	DA
1980s birthday party	GEN
Chevrolet Specs	GEN
group home help	GEN
bird block vent	BUY
altell cell phones	BUY
bike pegs	BUY
cambridge nursing school	GEN
buy console table	BUY
high school senior trip ideas	INFO
gas price locator	RES
how to do natural hair	DA
fema residential camps	GEN
entr stock price	DA
enlarged ascending aorta	GEN
free graphic photos	RES
foster children statistics	GEN
coconut shampoo and conditioner	BUY
disability apartments for rent	BUY
carpet cleaning franchise	GEN
fast typing keyboard	GEN
fire retardant polyester	GEN
base alkaline	GEN
How Do I Get My Car Appraised	DA
buss fuse panel	BUY
best phone of 2013	DA
adrenal gland pain	GEN
bright succulents	GEN
cookie ingredients	DA
highest fiber content	DA
homes in argyle texas	BUY
houses for sale beaumont	BUY
cable tv channel frequencies	GEN
diet plan lean	INFO
how to build a ranch	DA
family history background	GEN
cummins n14 engine	BUY
energy texas	GEN
foam rollers for exercise	BUY
acer phone support	NAV
commercial tree fertilizer	BUY
homemade thank you gifts	INFO
cpt code 99213	GEN
baking equipment for sale	BUY
chevy cube van	BUY
computer repair cost per hour	BUY
abbreviations in education	GEN
croatia airport code	DA
bottle scrubber	BUY
floor cleaner wax	BUY
endangered species charts	RES
best way for weight loss	DA
dip coating	GEN
elapsed time counter	RES
free logging magazines	BUY
how to load a rush card	DA
1999 Pontiac Bonneville	BUY
convert us tons to metric tons	DA
definition gold filled	DA
cheap used cymbals	BUY
government jobs in brazil	INFO
barbara long	GEN
fuel pump fuse	BUY
amaranth bread	GEN
gps tracker device	BUY
average dentist income	DA
compressed spinal cord in neck	GEN
banana pie filling	DA
criterion referenced test	GEN
construction measurements	GEN
carcinoma of the colon	GEN
how to format a proposal	DA
ballet equipment for home	BUY
articles in the times	RES
computers in walmart	BUY
court of honor ceremony	GEN
hospitals in tulsa oklahoma	INFO
car loan maybank	BUY
cards to send by email	RES
free inmate information	GEN
architectural project manager	GEN
apple wine recipe sweet	DA
compact gas grill	BUY
boeing college scholarships	GEN
distance from point to line	GEN
financial advisor facts	GEN
cca rating for batteries	GEN
bill security features	GEN
bucher hydraulic pump	BUY
basic peanut butter cookies	DA
cell phones and prices	BUY
double wall oven cabinets	BUY
desk for two people	BUY
flushing toxins	GEN
1969 boss mustang for sale	BUY
100 best rappers all time	DA
gct2 test practice	RES
christmas games for kids	INFO
cheap banjo for sale	BUY
car cd ipod player	BUY
hemochromatosis symptoms	INFO
crisis movie	GEN
cowboy stadium	GEN
deer facts for kids	GEN
how much is defensive driving	DA
advanced french grammar	GEN
cardiff airport arrivals	NAV
free puppies in melbourne	BUY
flame designs free	RES
fedex job listings	NAV
hoc waiting list	NAV
buy battery for laptop	BUY
cost for acupuncture	BUY
2013 1040a federal tax form	RES
hissing sound in wall	GEN
farm equipment mechanic	INFO
banded ear plugs	BUY
brown rice thai	GEN
cosigner for auto loan	GEN
all new movies in 2014	DA
calling international phone	DA
30 year interest rate history	RES
5.7 hemi crate	GEN
calculate fencing cost	DA
flowmaster 10 series	GEN
aluminum acetate powder	GEN
catastrophic health insurance	GEN
banda san miguel	GEN
ceiling lamp parts	BUY
crown beef roast	GEN
good names for bulldogs	INFO
air hogs f-14	GEN
arizona landmarks list	INFO
delete history chrome	DA
cabbage and pork sausage	DA
chevy lumina specs	BUY
best rv price	BUY
best 2013 vehicles	DA
cash advance in nc	INFO
change of address maryland	NAV
biology volunteer	GEN
check oci application status	NAV
floor freezer	BUY
best ankle weights	BUY
hotels near westchester airport	INFO
how to sell your phone	DA
custom dog portraits	BUY
counting sequences	GEN
chamberlain garage door repair	NAV
front axle shafts	GEN
causes of adjustment disorder	INFO
espanola new mexico	GEN
causes of dysphasia	INFO
baptist church orlando	INFO
how to make a music blog	DA
grenadine syrup ingredients	DA
baking soda prices	DA
bleeding after menapause	GEN
free videos album	RES
baby stools	BUY
how to double dutch	DA
gallery tube	RES
herndon family	GEN
ftse stock index	GEN
houses for sale pictures	RES
full episode of ncis	RES
feeling good by burns	RES
aquacell battery review	NAV
best midsize sedan gas mileage	DA
education in soviet russia	GEN
corgi dogs miniature	GEN
a and a furniture	NAV
dakota snow plow	GEN
cylinder heads	BUY
classroom teaching styles	GEN
dodge challenger clothing	BUY
food service	GEN
drapery styles	GEN
facts about hollister	GEN
cracker barrel prices	RES
black friday tigerdirect	NAV
christmas holiday malta	GEN
aberdeen job fair	GEN
head lice rash	GEN
free candle clipart	RES
average interest rate used car	DA
configuration of computer	GEN
how to jailbreak any phone	DA
19th century french culture	GEN
buy cans	BUY
french riviera	GEN
baby registry gifts	INFO
exchange commission	GEN
free apa templates	RES
battery size aa	GEN
cabins for sale in victoria	BUY
exclusivity contract sample	RES
cordless upright vacuum	BUY
blood sugar 195	GEN
catholic courses online	INFO
honda crf250r top speed	DA
how many ounces in cl	DA
electronic control system	GEN
how to put a security freeze	DA
goodman ac	GEN
flashpad 2.0	GEN
2013 ford f 150 pickup	GEN
buy used snowshoes	BUY
body bolts	GEN
2014 chevy silverado engine	GEN
Can You Get A Job At 15	DA
how to withdraw your 401k	DA
hdl ldl triglycerides levels	GEN
auto assembly jobs	INFO
emirates visa credit card	BUY
free medical webinars	INFO
brown cable box	GEN
financial education kids	GEN
hindi movies film	GEN
free world wide games	NAV
door panel cadillac	BUY
basketball academy	GEN
credit rating information	GEN
baby shower slogans	INFO
games for 3 grade	INFO
does fruit have sodium	DA
bill of rights worksheet	RES
happy diwali cards	RES
downloadable bible	RES
egypt civilization	GEN
bike safety quiz	RES
feeding pet turtles	GEN
dream meaning pregnancy	GEN
artistic gift baskets	GEN
cap for boys	BUY
ebay truck cap	BUY
auger equipment	GEN
bullying lessons for kids	INFO
2500hd chevy for sale	BUY
chevy 4 wheel drive trucks	BUY
how to clean new potatoes	DA
cheddar cheese soup recipes	INFO
gaston christian school	NAV
driving license europe	GEN
high quality machetes	BUY
affidavit in support	RES
bissell manuals	RES
fireplace with tv on top	GEN
Car Price Value	BUY
casual skirt outfits	INFO
dryer power cord replacement	BUY
all army games	GEN
11.6 inch netbook	BUY
cougars in illinois	INFO
foundations in bay area	INFO
american tire discount	BUY
cross insurance company	NAV
auto check center	NAV
gadget gift	BUY
48 inch tv dimensions	DA
environment california	NAV
health search engine	NAV
cowboy style furniture	BUY
birch tree logs	BUY
glucose level guidelines	GEN
disability claims specialists	INFO
berkeley used cars	BUY
dog behavior schools	INFO
Fancy Appetizers For Parties	INFO
aftermarket stores	INFO
bplans sample business plans	RES
free printable room signs	RES
dell xps m1340	BUY
free sales catalog	INFO
ferns for shaded area	BUY
a zip code in usa	INFO
american actors 1950s	INFO
blue glazed pottery	BUY
causes of bunions on feet	INFO
airbrush markers	BUY
car insurance problems	GEN
check insurance online	DA
free clip art falling down	RES
doctors and nurses	GEN
axe dandruff shampoo	BUY
benz g55 price	BUY
flower seeds that grow fast	INFO
funny famous quotes about life	RES
ds 82 fee	BUY
high school horror	GEN
cake doctor banana cake	NAV
40 hour work week schedules	RES
green apple dresses	BUY
apples to apples game	BUY
does vertigo affect your eyes	DA
fun winter things to do	INFO
calculate per annum	DA
aluminum commodity price	BUY
food tray table	BUY
bench clothing canada	NAV
golf stores honolulu	INFO
calendar moon 2014	RES
blaine school	NAV
body detox products	BUY
easter skit for kids	INFO
cconly chicken coops	BUY
current politics	GEN
antique screen doors	BUY
airborne challenge coin	GEN
best brake shoes	DA
executive business programs	GEN
baby milo clothing	BUY
anatomy of the upper back	GEN
clay for body wraps	BUY
acting jobs in california	INFO
henckels nail clippers	BUY
are tree frogs poisonous	DA
coptic tv channel	NAV
ceramic mold making	GEN
cell phone alcatel	BUY
fix my usb drive	DA
fiskars replacement parts	BUY
ancestry by last name	GEN
another word for subjects	DA
bath bed and breakfast	GEN
golf club of oklahoma	NAV
best living room chair	BUY
how many oceans in the usa	DA
gift ideas for new teachers	INFO
Alumina Spot Price	BUY
corolla	BUY
free skate catalogs	INFO
examples of trading cards	RES
alliance airport jobs	NAV
bladder control male	GEN
area code 503 city	DA
couples gifts for him	INFO
house plants pots	BUY
alberta grid system	GEN
city tv ca	NAV
ankle boots peep toe	BUY
gay social groups	GEN
gospel songs oldies	RES
cscp exam questions	RES
home heating radiators	BUY
highest point in nc	DA
free ads for nonprofits	GEN
circular wet saw	BUY
buy avatar costume	BUY
avenue coupon code	RES
community care journal	RES
great things to do in portland	INFO
how to mix powdered milk	DA
cnn news monday	GEN
6 month insurance	GEN
collection canada	GEN
asu health insurance	NAV
best trash cans	DA
5 year interest rate	GEN
delicious tuna salad recipe	DA
build bocce court	DA
discontinued stereo	BUY
apartment rentals seattle	BUY
hpv throat symptoms	INFO
hats t shirts	BUY
color scheme combinations	GEN
best electric drills	DA
buying digital camera	BUY
dry sinuses	DA
cd reviews	RES
home equity second mortgage	GEN
buy plaques online	BUY
christmas lace	BUY
banana nut cake	DA
dried salmon	GEN
aerospace vacuum pump	BUY
alvania grease	BUY
freckle like rash	INFO
big jon boats	BUY
architectural wall hangings	BUY
97 mustang spark plug gap	GEN
delta scroll saw	BUY
german made cellos	BUY
electric hybrid suv	BUY
devry university tuition	DA
book mark templates	RES
elizabeth grant	GEN
fall in love quiz	RES
erp project plan	RES
cartoon person walking	RES
events happened 2006	INFO
home building designs	RES
history alive textbook	BUY
embolism in leg	GEN
2004 dodge caravan	BUY
corbett national park	NAV
gas stove top cleaner	BUY
english classes in dc	INFO
diagnosing add	GEN
gatwick airport parking	NAV
airports blue ridge	INFO
bentonville rental homes	BUY
flush wheels	DA
airstation router	BUY
glitter lipstick	BUY
education jobs in oklahoma	INFO
how do you use square	DA
build king size platform bed	DA
how to induce labor fast	DA
how to diagnose colon cancer	INFO
brazil consulate	NAV
doll house plans free	RES
bake school	GEN
highway 2 crashes	INFO
culinary sage	GEN
fox imus in the morning	NAV
caleffi air vent	BUY
How To Plug A Tire	DA
best high arch support	DA
hidden images in pictures	DA
gold warcraft world	NAV
how much is a ring appraisal	DA
chat room pakistani	NAV
brain spasm symptoms	INFO
ceramic lamp shades	BUY
aluminum cake pan	BUY
Floor Consoles For Trucks	BUY
can i buy caboki in stores	DA
fabric sectional	BUY
dress 1980s style	BUY
heat regulator	GEN
all about the cougar	GEN
dusty richards books	BUY
hot look makeup	GEN
honda atv 250cc	BUY
great falls montana	GEN
design your floor plan	NAV
cigna live chat	NAV
flash for panasonic	BUY
2014 gymnastic olympics	GEN
building a retaining wall	DA
capitalization after colon	DA
how to interview a patient	DA
android 4.4 1	RES
aberdeen to manchester	RES
how much kefir to drink a day	DA
average tire pressure for car	DA
attorney san antonio	INFO
eat this not that website	NAV
bleeding under fingernail	INFO
garlic dill sauce	GEN
giant post it	BUY
free cocoon patterns	RES
european beauty products	BUY
free thank you quotes	RES
aeolus down comforter	BUY
criteria for home health care	INFO
free tones net	NAV
divorce certificate sample	RES
economic crisis 2012	GEN
auto parts from junk yards	BUY
how to draw picture	DA
audio pcm format	GEN
burlington local newspaper	NAV
cdl grants for cdl training	INFO
4g lte maps	RES
dana phone number	DA
ct home show	GEN
how to buy glasses	DA
eldorado county jail	NAV
dove dish soap	BUY
how to use a bamboo steamer	DA
high grass mower	BUY
alimony laws in nevada	GEN
average loan interest rate 2013	DA
floresent light covers	BUY
how to catch perch	DA
home in a trust	GEN
gardeners in san francisco	INFO
biotin and zinc taken together	GEN
club event names	GEN
employment sectors list	RES
b 52 18	BUY
crockpot candy recipes	INFO
best french salt	DA
how do you get rid of radon	DA
best pet insurance for dogs	DA
broken iphone 4g	GEN
city of arcata water	NAV
dresslink coupon code	RES
duolingo english	NAV
donkey kong ps3	BUY
hard surface disinfectant	BUY
gold price kitco chart	RES
2 way zipper	BUY
heat wave book	BUY
honda motorcycle performance	BUY
all regal theaters	NAV
flight tickets to orlando	BUY
door handle extender	BUY
cena wrestling	GEN
harvest market	NAV
drilling rigs jobs	INFO
blood sugar levels mg dl	GEN
exercise training chart	RES
gold investment group	NAV
golf tournament schedule	RES
costco laptop computer	BUY
book stores in irving	INFO
excel 2014 microsoft	BUY
how long is 32 inches	DA
galaxy s3 free	BUY
af pay scale	RES
free list of company names	RES
facts about moles animals	GEN
country home design plans	RES
crossflow cooling towers	BUY
cars in india in 2014	GEN
go bus cost	BUY
gsn all games	NAV
catfish breeding	GEN
florida osha requirements	RES
blood sugar meter no blood	GEN
bath pro	NAV
filipino movie watch	RES
Brass Stock Prices	BUY
bus plug	GEN
furniture sale tucson	INFO
free death reports	RES
big bend national park	NAV
alternatives to high school	GEN
condos for rent in barrie	INFO
dessert pineapple recipes	INFO
best buy lg smart tv	BUY
heater dog house	BUY
1926 half penny	GEN
bad teeth hygiene	GEN
averatec all in one computer	BUY
frog nursery theme	GEN
computer repair hawaii	INFO
abs wheel sensors	BUY
fence replacement cost	DA
did dream act pass	DA
flatscreen tv prices	BUY
how to build a pool fence	DA
cooking with orzo recipes	INFO
computer desk help	GEN
barcelona restaurant menu	INFO
gain fast 3100	BUY
free kittens in nyc	BUY
electric cd player	BUY
hatchback cars for sale	BUY
city of west chicago	NAV
heb cash checks	NAV
different life insurance	GEN
american church list	INFO
craigslist cars sarasota	BUY
diabetes and mood swings	GEN
auto show where to park	DA
columbus ohio sites	GEN
concrete form stakes	BUY
homes in russia	BUY
can irs garnish social security	DA
attitude surveys	RES
facts online tuition	NAV
adhd and education	GEN
carle hospital directory	NAV
1995 chevrolet truck parts	BUY
champlain mall stores	INFO
capitec car finance	NAV
how to cook chicken recipes	INFO
dutch foods	INFO
french quarter paintings	BUY
close shave razor	BUY
best gaf shingles	DA
creek indian village	GEN
french 75 recipe	DA
how to choose colors	DA
high school camps	INFO
hot wheels retailers	INFO
chlorine shower filters	BUY
government money for seniors	GEN
army jrotc shoulder cords	INFO
best deep hair treatment	DA
fidelity retirement funds	NAV
fun anniversary gifts	INFO
comanche indian culture	GEN
adjunct professor	GEN
allen family foods	NAV
capital of andorra	DA
Beach Wedding Cupcakes	DA
free puppies minnesota	BUY
causes of vomiting yellow	INFO
delete all downloads	DA
copyright release form sample	RES
best korean drama	DA
dc restaurant guide	INFO
business scams	INFO
how to control sweating	DA
all kinds of maps	RES
food survey template	RES
farm tax rules	INFO
ankle pain diagram	RES
cross country skiing apparel	BUY
amazon record albums	NAV
best humidors for the money	BUY
horse pajamas	BUY
cheap vacation packages	BUY
facts of birds	GEN
hair salons near me	INFO
free todo software	RES
atlanta and georgia	GEN
how to clean drainage pipes	DA
ge television manuals	RES
baby blanket edging	DA
adopt a pet finder	NAV
cydia for 4.2 1	RES
candy for babies	GEN
allowable deductions for irs	INFO
get more fiber in your diet	DA
fda allergen list	NAV
clam broth	DA
how to use empi tens unit	DA
doctor home visit	GEN
dance furniture	NAV
computer picture gallery	RES
eradicate moles	DA
backpage women for men	NAV
how to make urethane foam	DA
clearwater beach tampa	GEN
accounting for factoring	GEN
coconut oil water	GEN
calories in garden salad	DA
ameritech online college	NAV
baby back ribs cooking time	DA
fix disk errors windows xp	DA
forex pricing	BUY
basic math pre algebra	GEN
bobby bare	GEN
1970 challenger r t	BUY
google my tracks iphone	NAV
aluminum sulfate formula	DA
call center jobs in ct	INFO
boilermaker aptitude test	GEN
bolton courts cases	NAV
fbc blood test	GEN
brown eye shades	RES
auto repair plans	INFO
child seizure	GEN
chi farouk iron	BUY
charlottesville house for rent	BUY
accounting financial management	GEN
french classes for adults	INFO
flashpoint tv schedule	NAV
freeze multiple panes	DA
direct deposit services	INFO
hiv virus pictures	RES
geneva county	GEN
designer clothes online	BUY
debt summons	GEN
cheap 80cc dirt bikes for sale	BUY
gas signs for sale	BUY
free government school grants	INFO
alaska air travel	NAV
construction jobs in virginia	INFO
airports in iowa map	RES
free printable will kit	RES
diagnosis gout	GEN
fishing hats cheap	BUY
buses to indianapolis	INFO
finale 2014 software	RES
how much to replace gutters	DA
d day information	GEN
commercial bill of sale	GEN
glass range hoods	BUY
express machine	BUY
duct tape and wart treatment	DA
1 gold coin price	BUY
depends online	NAV
dermatology nurse jobs	INFO
brightstar health care	NAV
about mac computers	NAV
geological current events	INFO
how to use a silver bullet	DA
cutlass seat covers	BUY
electronics from china	BUY
courier names list	INFO
central park carriage	BUY
appreciation statements	INFO
common snipe bird	GEN
buy british food	BUY
a taste of puerto rico	BUY
best phone insurance	DA
facts about the blue angels	GEN
apostolic radio live	NAV
can am spyder maintenance	NAV
dog show supplies	BUY
Acura Tl Recalls 2005	DA
creating a credit card	DA
bridal make up ideas	INFO
budget tools online	NAV
buckwheat cake	DA
best architectural websites	NAV
flu shot safety	GEN
bge mailing address	NAV
cardone phone number	NAV
bride to be nail polish	BUY
hand ratchet	BUY
free cell phones by mail	BUY
cake icing nozzles	BUY
ethics in group work	GEN
front door with sidelights	BUY
big state auto auction	NAV
hiv aids cure research	GEN
airport code for guam	DA
cna 1 jobs	INFO
free photo birthday cards	RES
allergies asthma	GEN
churches that give free food	INFO
decorative branches	BUY
fedex tracking details	NAV
freezing root vegetables	DA
children with no empathy	GEN
double gold stock	GEN
doctor who images	RES
another word for issue	DA
highest paying jobs 2014	DA
asp programming language	GEN
all types of music videos	GEN
animal breeding games	RES
accelerate video	DA
honey lemon	GEN
4th of july flags	BUY
business workshops	INFO
bar top lighting	BUY
green iguana breeders	INFO
good car offers	GEN
help with parking tickets	GEN
blood viruses	GEN
hca accounts payable	GEN
does tria hair removal work	DA
how much are oil pumps	DA
extensor digitorum brevis	GEN
florida funeral homes	INFO
glow in dark contacts	BUY
heavy duty plastic pipe	BUY
entertainment wall unit	BUY
flat iron recommendations	DA
engine parts catalog	RES
best otoscope for home use	DA
hearing loss cures	INFO
hot water tank plumbing	GEN
2pac book of poems	BUY
heated air bed	BUY
cosmetic doctor	GEN
home credit union	NAV
credit card budget	GEN
deflation rate formula	DA
alexander picture	RES
bi mart lancaster salem or	INFO
anti aging products	BUY
famous drum sets	INFO
chronic diarrhea treatment	INFO
free dating sites in asia	NAV
animal horns for sale	BUY
great paladin names	INFO
buying a new car online	DA
chow chow chutney	DA
diamond head snake	GEN
atelier fashion	GEN
clean shine tile floor	DA
clear plastic tables	BUY
cheap stethoscopes for sale	BUY
bulk rice bran	BUY
cure for nerve damage	DA
florence arizona map	RES
best turkey fryer	DA
health insurance for realtors	INFO
alexandria egypt	GEN
5m usb cable	BUY
floor plans dream homes	RES
build a plasma cutter	DA
classic bible movies	INFO
century 21 new york city	NAV
hair salons in tallahassee fl	INFO
family breaks	GEN
amish factory outlet	NAV
how to fix security error	DA
baudville coupon code	RES
abdominal wall hernia types	INFO
2013 federal tax form 4562	RES
football kits	BUY
best mohawks hairstyles	RES
free tv converter	BUY
how to cook steel cut oatmeal	DA
dress for less online	NAV
cob houses for sale	BUY
check my computer	DA
corporate market research	GEN
air show.com	NAV
buy visa debit card	BUY
frozen food dinners	INFO
delta airlines laguardia	NAV
galaxy quiz	RES
geometry online for free	NAV
cute frog sayings	INFO
citizens united ruling	GEN
california sandals	NAV
hair styles for seniors	RES
hooded fleece	BUY
dwarf hamster for sale	BUY
brocolli pasta salad	DA
dimmable puck lights	BUY
free simpsons games downloads	RES
erisa appeal letter	NAV
furniture parts feet	BUY
bar graphs for math	GEN
cubetti yarn patterns	NAV
cell phone stolen	GEN
creamy chicken pasta dishes	INFO
conduit repair kit	BUY
how to do your w2	DA
how is genital warts treated	DA
demarest high school	NAV
colleges of new york city	INFO
a matter of fax	NAV
clearly contacts lenses	BUY
green screen camera	BUY
colorado month to month lease	BUY
amyris essential oil	BUY
egypt movies free online	RES
honorary doctoral degrees	GEN
bolek craft supplies	NAV
fence razor wire	BUY
castile soap as shampoo	GEN
car battery charger schematic	RES
communication disorders	GEN
chicago il tattoo shops	INFO
cant stream videos	DA
adventist singles chat	NAV
how to root my device	DA
Auto Oil Pressure Gauge	GEN
english words from german	RES
how to put on eye makeup	DA
chuck taylor coupons	RES
charleston humane society	NAV
halloween church	GEN
1990s pop culture	GEN
am radio antenna diy	DA
biosphere activity	GEN
how to paint circles on walls	DA
camcorder software	RES
board of ironing	NAV
buy retainers	BUY
austin exotic cars	BUY
financial statement short form	RES
free mlm companies	INFO
adkins	GEN
how to repair window blinds	DA
garden flowers annuals	INFO
fern plant identification	INFO
arizona treatment center	NAV
how to set up lan	DA
buttermilk brownies	DA
health fair screenings	GEN
healthy protein diet plan	INFO
broccoli reunion salad	DA
hair styles for teenage girls	RES
bud light commercials	RES
coax cable	BUY
full mattress clearance	BUY
forklift study guide	RES
attractive women over 60	GEN
debt collection advice	GEN
green river wyoming	GEN
dana replacement parts	BUY
banners banners everywhere	NAV
can avocados make you fat	DA
apple old products	INFO
dark brown baskets	BUY
forms probate	RES
energy metabolism pills	INFO
farmers choice organics	NAV
capital lease examples	INFO
flavored chicken recipes	INFO
1999 chevrolet blazer	BUY
24 carat gold	GEN
buick 300	BUY
graphic card external	BUY
a plus cleaning	NAV
facts about lemons	GEN
cannoli dough recipe easy	DA
fixed income products	INFO
donate car for tax credit	DA
horse rescue adoption	INFO
detroit to grand rapids	DA
current price of stamps 2014	INFO
animal kingdom zoo	NAV
ceramic paint markers	BUY
harbor tool and freight	NAV
how high is a bar stool	DA
clear decals	BUY
clean kitchen sink drain	DA
different heart rhythms	GEN
deni hot plate	BUY
how to use urinal blocks	DA
birthday greetings free	RES
ctl dividend history	GEN
2014 tax limits table	RES
alitalia flight status	NAV
geography in the news	GEN
bosch mixer parts	BUY
breaking bad reruns	RES
cake stand hardware	BUY
can you dye leather	DA
fairfield traffic court	NAV
cleaning ceramic	DA
cheese con queso recipe	DA
cbest writing prompts	INFO
colonial passenger lists	GEN
form i-864 pdf	RES
aquarium plant lighting	BUY
framing labor rates	BUY
build a computer parts	DA
herbal tea for ibs	GEN
college school ratings	GEN
free motivational poster	BUY
how to steam crabs	DA
1950s home decor	GEN
drones over america	BUY
gulf vacation packages	BUY
chinese drivers license	GEN
disney rewards codes	NAV
bosch silence plus	BUY
bride survival kit	GEN
famous artists for pottery	INFO
blue hair combs	BUY
gender neutral kids	GEN
arizona's climate	GEN
figure skating gear	GEN
character lesson plans	RES
cookies by design	NAV
how much does alli cost	DA
as seen on tv pan	BUY
free church items	INFO
Christmas Blogs	NAV
fake stainless steel	GEN
free family tree layouts	RES
dots application	NAV
cheap replacement cushions	BUY
algonquian family life	GEN
diving flippers	BUY
cosco in north carolina	NAV
chicken recipes the chew	NAV
dove pictures free	RES
easter sunday in 2014	DA
copyright on old photos	GEN
chrysler new logo	RES
event supplies checklist	GEN
cause and effect passages	INFO
bunionectomy surgery recovery	GEN
chain of custody forms	RES
cost of decra roofing	BUY
free copy of spreadsheet	RES
cnn money markets stocks	NAV
canon pixma pro-1	BUY
hardees breakfast times	DA
Best Medical Jobs	DA
clay kilns	BUY
alltel flip phones	BUY
connect ps3 controller	DA
dryer lint trap cleaning	DA
card playing joker	RES
erie university	NAV
green mountain stock price	BUY
best flea spray for house	DA
800 number phone directory	RES
black mohawk hairstyles	RES
Gadgets For Iphone 4	BUY
cna competency exam	GEN
club in atlanta georgia	INFO
diet recipes mince	INFO
bank of atlantic center	NAV
best price acer aspire one	BUY
corbin electric car	BUY
best weight loss workout routine	DA
efile income tax returns	DA
chicken wings flavors	INFO
chemical damage to hair	GEN
dualit toaster reviews	BUY
caravan insurance policy	NAV
gap warehouse jobs	INFO
bankruptcy and tax refunds	GEN
centerpoint tape measure	BUY
clear plan easy	BUY
exterior wood walls	GEN
flame retardant spray	BUY
animals in everglades	GEN
easy parsnip soup	DA
carnegie classes	NAV
divorce finances	GEN
can am miami	BUY
exercise sneakers	BUY
dreads hairstyle	RES
china clothing stores	INFO
how to open yale safe	DA
element clothing	NAV
hp laptop g56	BUY
art schools	INFO
child rearing practices	INFO
bach music download	RES
front office supervisor	GEN
bed frames on wheels	BUY
cold creams for face	BUY
ee shoe width	DA
cheat engine 6.6	RES
comfortable recliner chair	BUY
941 for 2011 forms	RES
how to get a man to marry you	DA
din pipe sizes	INFO
boston harbor closed	DA
gold mining claims idaho	INFO
breakfast sausage coupons	RES
best frozen drinks	DA
how to get soft waves in hair	DA
heb grocery ad	RES
funny church sayings	INFO
bakelite credit union	NAV
baby powder fleas	GEN
british airways specials	BUY
float boats fishing	GEN
how to call celebrities	DA
big toe inflammation	GEN
group 1 clematis	GEN
Find Cell Phone Locations	DA
cajun tomato sauce	DA
hp pavilion m9000	BUY
buy old police cars	BUY
enfalac baby formula	BUY
crosswords games free online	NAV
how to rock nick	DA
another name for desert	DA
health problems in mexico	INFO
bresnan cable tv	BUY
bed bugs terminix	NAV
dining chairs clearance	BUY
good game studios	NAV
black diamond equipment	BUY
business insurance premiums	GEN
cash bonus credit card	GEN
how to clear up adult acne	DA
accountant cpa	GEN
deer hunting pictures	RES
glass pebbles for vases	BUY
austin dentist	INFO
butler university schedule	NAV
dogs with cancer	GEN
free payment log	RES
dove soap campaign	NAV
dealer of motorcycle	INFO
car auctions in halifax	BUY
genetic flow	GEN
canada history timeline	RES
determine shoe size	DA
healthcare gap insurance	INFO
computer power back up	DA
best crabbing locations	DA
best anniversary gifts for him	INFO
ford focus lx	BUY
connetquot school district	NAV
how to get rid of uniblue	DA
free iranian movies	RES
ceramic love birds	BUY
festivals long island	INFO
attributable risk	GEN
e-z on auto tops	BUY
famous japanese paintings	INFO
free nursing grants	INFO
cheap floor plans build	INFO
all about netbooks	GEN
civil engineering handbook	RES
blazers for women	BUY
goodwill store indiana	INFO
fun lip gloss	BUY
aadvantage credit cards	NAV
chevrolet rebuilt engines	BUY
holocaust museum	GEN
7 continents	GEN
how to write a blog entry	DA
freeware text editor	RES
floor tile brands	INFO
1991 dodge ram pickup	BUY
hospitals in new york city ny	INFO
green tea with ginseng	GEN
homeless shelters in ohio	INFO
cowboy clothes	BUY
figurative art galleries	INFO
electric chair stairs	BUY
abraham lincoln ancestry	GEN
curtain rods decorative	BUY
bentley car interior	RES
free acting camps	INFO
car incentives and rebates	BUY
dance steps for the waltz	DA
free document scanner app	RES
average income of lawyers	DA
city news service	NAV
esp ltd price	BUY
flat rocks for landscaping	BUY
anderson city jail	NAV
bangor basketball tournament	GEN
coffee beans for decoration	BUY
1966 chevy ii	BUY
almond butter uses	INFO
free pak tv	NAV
bracelets prices	BUY
cebu travel	NAV
diabetes latest treatment	GEN
audio stereo installation	GEN
deer camera pictures	RES
dogs for rehoming	INFO
deluxe chicken coop	BUY
1976 eisenhower silver dollar	BUY
business analyst qualifications	INFO
halloween dance party	GEN
free full indian movies	RES
cabins for rent in idyllwild	BUY
beartooth highway map	RES
disneychannel music videos	NAV
goldwing aspencade 1200	BUY
grocery store local	INFO
flight tracker usairways	NAV
1972 trucks for sale	BUY
california king bed sheets	BUY
atherosclerosis research	GEN
estimated taxes 2013 due dates	DA
3g phone covers	BUY
how do we recycle	DA
how to read hands	DA
30 gallon drum	BUY
hotels in lake powell	INFO
africa magic	GEN
big lashes	GEN
head injury pain	GEN
bearing and hub	GEN
candy corn mold	BUY
blazers for girls	BUY
facts of obesity	GEN
easy free coupons	RES
how to debug	DA
fairchild tv schedule	NAV
dental crown infection	GEN
bowel conditions	INFO
bcbstx medicare advantage	NAV
free tide coupons	RES
hair stylist mississauga	INFO
franchise promotion	GEN
entering canada from the us	DA
2nd time home buyer	GEN
high gluten flour	BUY
broiled potatoes	DA
australian phone directory	RES
cute scrapbook sayings	INFO
dental society	INFO
bing wallpapers download	RES
4g phone plans	BUY
george c. marshall	GEN
english bicycle	GEN
cause of disability	INFO
aspirin for acne	GEN
39 ford for sale	BUY
abc plumbing	NAV
business mileage form	RES
gondola rides	GEN
alaska maps free	RES
how to make a carnival booth	DA
automotive market size	GEN
bb&t insurance services	NAV
charles frazier books	INFO
bayshore zip code	DA
community application	RES
cost of 1 kilowatt hour	BUY
difficult people training	GEN
hand reduction surgery	GEN
2014 sierra recalls	DA
fast relief for constipation	GEN
how to make shrimp linguini	DA
composite tooth	GEN
gas companies in augusta ga	INFO
george foreman fights	GEN
Apple Computer Stock	BUY
breathing abnormalities	INFO
courtyard times square	NAV
first alliance	NAV
earn amazon points	DA
acrylic urethane caulk	BUY
fishing for bass	GEN
coconut water drinks	INFO
halloween names for drinks	INFO
brooks running	BUY
free notices template	RES
free fire detectors	BUY
french braid quilts	DA
how do you prevent sweating	INFO
hearing devices for hard of hearing	BUY
gallery lighting	GEN
help for disabled veterans	INFO
graduate schools in iowa	INFO
10 gallon jug	BUY
ford thunderbird history	GEN
chair molding	GEN
clogged pores dry skin	GEN
borgen season 2	BUY
design cookies	DA
furniture rental minnesota	INFO
all trees names	INFO
how to tick people off	DA
hospital in winchester va	INFO
gym agreement template	RES
drum set tattoos	RES
can you cure tuberculosis	DA
atlas auto glass	NAV
cat rescue shelter	INFO
app for spell check	RES
hotel chain names	INFO
help for men in divorce	GEN
biodex system 2	BUY
catholic skull cap	GEN
dinner speeches	GEN
advances in solar energy	GEN
beach zip code map	RES
anemia cats	GEN
austin texas new year	INFO
best printer to use with ipad	DA
best vein treatment	DA
blue mountain lodging	INFO
furniture outlet nh	INFO
french to english learning	GEN
fireplace shield	BUY
best bike routes	INFO
articles on hiv	RES
depression hoarding	GEN
how do you tie a square knot	DA
best pools	DA
art of peru	GEN
eyebrow hair transplants	GEN
easy photo maker	INFO
draw comic strips	DA
easy heat heat tape	BUY
hotel circle hotels	INFO
denver monthly rentals	INFO
ga 500ez form	RES
german doughnuts recipe	DA
great christian music	INFO
dna mouth swab test	GEN
brain cancer wristbands	BUY
house flipping loans	INFO
california railroad map	RES
do cars talk	DA
birth order traits	INFO
container office for sale	BUY
club hockey	GEN
canberra house rentals	BUY
college government loans	INFO
gt suspension	GEN
how to make glass candy	DA
earring card template	RES
common cold contagious period	DA
axl rose	GEN
current deficit	GEN
car pollution statistics	GEN
emergency fire equipment	GEN
before the birth of christ	GEN
free optimization tool	RES
2008 eclipse	GEN
hoover cyclonic reviews	BUY
free employee resumes	RES
finance study guide	RES
go karts georgia	INFO
christmas tree lot	INFO
discounted cash flow	GEN
bonefish copycat recipe	DA
california water resources	NAV
cookies australia	INFO
how to make a zombie prop	DA
add adult quiz	RES
best baby bunting	DA
auger stove	BUY
a gift that says i love you	INFO
connect plus management	NAV
grade level	GEN
car auctions in nc online	NAV
get activation key	DA
cardiac dysfunction symptoms	INFO
hell on wheels movie	BUY
airports ontario canada	INFO
how to write story script	DA
african shirts for men	BUY
corona property management	NAV
how to use a power edger	DA
durabrand cd player	BUY
garden art statues	BUY
ear plugs waterproof	BUY
funky hair accessories	BUY
how do u make symbols	DA
390 intake manifold	BUY
delta bonnet nut	BUY
avengers books	BUY
fermenting chicken feed	DA
how to patent music	DA
chicago mayor	DA
electrical training school	INFO
aa associates degree	GEN
hebrew letter for 6	DA
high power scopes	BUY
best gyms in maryland	INFO
hot springs hotels	INFO
allergic to red 40	GEN
asap international travel	NAV
ansmann battery chargers	BUY
adult add resources	INFO
elmira pick a part	INFO
hair salons in woodbury	INFO
dance fort worth	INFO
house of color	NAV
elite can lights	BUY
how to organize yourself	DA
elements of risk management	INFO
credit wizard	NAV
bra with clear sides	BUY
how long is veterinary school	DA
fuel burn rates	GEN
brooklyn fair	GEN
fifa calendar 2014	NAV
cost of mining coal	BUY
ceramic water bottle	BUY
compaq laptops cost	BUY
florida bahamas	GEN
epa training courses	INFO
car auctions in fresno	INFO
download photos app	RES
how to install tpo roof	DA
how to make pretty nails	DA
effect of poverty	GEN
firefox free download	RES
convert picture to words	DA
ford mustang features	BUY
Great Wolf Lodge Rooms	NAV
emr training program	INFO
drink water during pregnancy	GEN
education career fair	GEN
gerber bars	BUY
9 year old birthday party	GEN
factor transfer	GEN
adult travel	GEN
educare	NAV
att internet service phone number	NAV
barrel lifter	BUY
dating petite women	GEN
curly hair products	BUY
general store franchise	GEN
acdf spinal surgery	GEN
how long does a coma last	DA
how to stain cedar siding	DA
arlington nursing home	INFO
how to build a tall table	DA
cashier test sample	RES
free online cle	NAV
eclipse in 2014	GEN
good costume ideas for teens	INFO
bleeding from esophagus	GEN
cnn news website	NAV
attwood gas cap	BUY
chevy parts oem	BUY
christmas shirts for men	BUY
how to build wooden steps	DA
find voter id	DA
conns tv sale	BUY
drilling contractors or	INFO
facts about the year 1919	GEN
home shed kits	BUY
how to get a smart serve	DA
great world ltd	NAV
free terraria account	NAV
how to up date bios	DA
agricultural agencies	INFO
dc current switch	BUY
development engineer salary	DA
chills and nausea	GEN
dinner meals ideas	INFO
cheap weddings packages	BUY
excursions from barcelona	BUY
hot pink tiara	BUY
avengers full episode	RES
christian girls	GEN
definition of remember	DA
formula for percent	DA
houses for sale in essex	INFO
cheap wine list	INFO
definition of meaningful use	DA
blaine duty free	NAV
how can i stop eating sweets	DA
How To Fix Exhaust	DA
does depression cause dizziness	DA
airline ticket center	NAV
help for spelling	GEN
18th birthday party ideas nyc	INFO
esophagus stent	GEN
free skoal coupons	RES
60 anniversary corvette	BUY
braun series 1	BUY
escalade owners manual	RES
cancer antibody therapy	GEN
cats & kittens munchkin	GEN
cost of milk in 2000	DA
8 napa auto parts	NAV
business asset finance	GEN
free timesheet forms	RES
example of essay writing	DA
anti aging acne skin care	GEN
1961 willys jeep	BUY
drinking age on a cruise	DA
california welfare reform	GEN
glacier bay facts	GEN
facts about birth control	GEN
average us army salary	DA
bible study psalm	INFO
cover letter for cna	RES
air compressors explained	GEN
how to make sauce for crepes	DA
dodge dart engine	GEN
alamodome seating chart	RES
games to play in office	INFO
face corrector	GEN
best pineapple juice	DA
apple logo jacket	BUY
antique currency	GEN
bone marrow lymphoma prognosis	GEN
arrivals at jfk airport	NAV
better memory	GEN
ceramic tile trends	INFO
history of social studies	GEN
design my own game	DA
hoarseness and thyroid	GEN
all about carbohydrates	GEN
graphics card driver update	RES
elementary school teaching	GEN
honolulu apartment rental	BUY
flood deck stain	BUY
golden greek	GEN
find out what my symptoms mean	GEN
free excel spreadsheet	RES
form ds 82 fillable form	RES
famous foods in greece	INFO
alberta spruce dwarf	GEN
cbs mentalist episodes	NAV
career paths in human resources	INFO
antique copper sink	BUY
hairdo photos	RES
cake pops naperville	BUY
cheap iphones at walmart	BUY
glw stock dividend	BUY
books for law students	BUY
200 pound sandbag	BUY
cheapest used car	BUY
chicken bantam breeds	GEN
cant sell my house	INFO
home bedspreads	BUY
dvd drive toshiba	BUY
fatigue symptoms	INFO
dating when married	GEN
computer service template	RES
blue heron fishing	NAV
carpet cleaning advertising	INFO
dollar rental car	NAV
go card new york	NAV
homesense sale flyer	NAV
chanel 5 parfum	BUY
finishing wood cabinets	DA
alphabet blocks	BUY
construction jobs	INFO
cobras appearance	GEN
aircraft tracking systems	GEN
campbell's slow cooker recipes	NAV
home sold in neighborhood	INFO
frito lay crackers	BUY
hockey sayings quotes	INFO
facial piercing jewelry	BUY
golden wedding	GEN
